Wot, Wot, Wot, Wot, Wot, Wot, Wot, Wot, Wot, Wot, Wot, Wot, Wot, Wot, Wot, Wot, Wot, Wot, Wot, Wot, Wot, Wot, Wot, Wot, Wot, Wot, Wot, Wot, Wot, Wot, Wot, Wot, Wot, Wot, Wot, Wot, Wot, Wot, Wot, Wot, Wot, Wot, Wot, Wot, Wot, Wot, Wot, Wot, Wot, Wot, Wot, Wot, Wot, Wot, Wot, Wot, Wot, Wot, Wot, Wot, Wot, Wot, Wot, Wot, Wot, Wot, Wot
Wot, Wot, Wot, Wot, Wot, Wot, Hhd, Wwrt, Wwrt, Wot, Wot, Wot, Wot, Wot, Wot, Wot, Wot, Wot, Wot, Wot, Wot, Wot, Wot, Wot, Wot, Wot, Wot, Wot, Wot, Wot, Wot, Wot, Wot, Wot, Wot, Wot, Wot, Wot, Wot, Wot, Wot, Wot, Wot, Wot, Wot, Wot, Wot, Wot, Wot, Wot, Wot, Wot, Wot, Wot, Wot, Wot, Wot, Wot, Wwt, Wot, Wot, Wot, Wot, Wot, Wot, Wot, Wot
Wot, Wot, Wot, Wot, Ds, Ds, Mdd, Hhd, Ds, Wot, Wot, Wot, Wot, Wot, Wot, Wot, Wot, Wot, Wot, Wot, Wot, Wot, Wot, Wot, Wot, Wot, Wot, Wot, Wot, Wot, Wot, Wot, Wot, Wot, Wot, Wot, Wot, Wot, Wwt, Wot, Wwt, Wot, Wwt, Wwt, Wwrt, Wwt, Wot, Wot, Wot, Wot, Wot, Wot, Wot, Wot, Wot, Wot, Wwrt, Wwt, Ds, Wwt, Wwt, Wot, Wot, Wot, Wot, Wot, Wot
Wot, Wot, Wot, Wot, Ds, Ds, Ds, Ds, Hhd, Wot, Mdd, Ds, Ds, Wot, Wot, Wot, Wot, Wot, Wot, Wot, Wot, Wot, Wot, Wot, Wot, Wot, Wot, Wot, Wot, Wot, Wot, Wot, Wot, Wot, Wot, Wwt, Wwt, Wwt, Wwt, Wwt, Ds, Wwt, Wwt, Wwrt, Wot, Wot, Wot, Wot, Wot, Wot, Wot, Wot, Wot, Wot, Wot, Wwrt, Wwt, Ds, Gs^Ft, Ds, Wwt, Wot, Wot, Wot, Wot, Wot, Wot
Wot, Wot, Wot, Wot, Wwrt, Hhd, Hhd, Hhd, Hhd, Hhd, Hhd, Ds, Hhd, Wot, Wot, Wot, Wot, Wot, Wot, Wot, Wot, Wot, Wot, Wot, Wot, Wot, Wot, Wot, Wot, Wot, Wot, Wot, Wwt, Wot, Wwt, Wwt, Hhd, Hhd, Hhd, Hhd, Hhd, Hhd, Wwt, Wwt, Wot, Wot, Wot, Wot, Wot, Wot, Wot, Wot, Wot, Wot, Wwt, Wwt, Gs, Gs, Dd^Do, Ds, Wwt, Wot, Wot, Wot, Wot, Wot, Wot
Wot, Wot, Wot, Wot, Ds, Hhd, Mdd, Hhd, Wwrt, Wwrt, Wot, Wot, Wot, Wwrt, Wot, Wot, Wot, Wot, Wot, Wot, Wot, Wot, Wot, Wot, Wot, Wot, Wot, Wot, Wot, Wot, Wwt, Wwt, Wwt, Wwt, Wwt, Wwt, Gd, Gd^Es, Hhd, Hhd, Ds, Ds, Wwrt, Wwt, Wot, Wot, Wot, Wot, Wot, Wot, Wot, Wot, Wot, Wot, Wwt, Ds, Gs^Ft, Gs^Ft, Gs^Ft, Ds, Ds, Wwt, Wot, Wot, Wot, Wot, Wot
Wot, Wot, Wot, Wwrt, Wwrt, Ds, Mdd, Hhd, Wwrt, Wot, Wot, Wot, Wot, Wot, Wot, Wot, Wot, Wot, Wot, Wot, Wot, Wot, Wot, Wot, Wot, Wot, Wot, Wot, Wot, Wwt, Wwt, Wwt, Ds, Ds, Ds, Ds, Gd^Es, Gd^Es, Hd, Ds, Wwt, Wwrt, Wot, Wot, Wot, Wot, Wot, Wot, Wot, Wot, Wot, Wot, Wot, Wwrt, Wwt, Ds, Ds, Ds, Ds, Ds, Wwt, Wwt, Wot, Wot, Wot, Wot, Wot
Wot, Wot, Wot, Wot, Wot, Hhd, Hhd, Hhd, Wot, Wot, Wot, Wot, Wot, Wwrt, Hhd, Wot, Wot, Wot, Wot, Wot, Wot, Wot, Wot, Wot, Wot, Wot, Wwt, Wot, Wwt, Wwt, Wwt, Ds, Dd^Es, Hd, Hd, Dd, Hhd, Hhd, Ds, Wwt, Wwt, Wot, Wot, Wot, Wot, Wot, Wot, Wot, Wot, Wot, Wot, Wot, Wot, Wot, Wwt, Wwt, Wwt, Wwt, Wwt, Wwt, Wwt, Wot, Wot, Wot, Wot, Wot, Wot
Wot, Wot, Wot, Wot, Wot, Wot, Wot, Wot, Wot, Wot, Wot, Wot, Wot, Wwrt, Mdd, Mdd, Wwrt, Wot, Wot, Wot, Wot, Wot, Wot, Wot, Wwt, Wwt, Ds, Wwt, Wwt, Wwt, Ds, Ds, Dd^Es, Hhd, Hhd, Dd^Es, Hhd, Hhd, Hhd, Wwrt, Wot, Wot, Wot, Wot, Wot, Wot, Wot, Wot, Wot, Wot, Wot, Wot, Wot, Wot, Wot, Wot, Wot, Wwt, Wot, Wot, Wot, Wot, Wot, Wot, Wot, Wot, Wot
Wot, Wot, Wot, Wot, Wot, Wot, Wwrt, Wot, Wot, Wot, Wot, Wot, Wot, Wot, Wot, Hhd, Wot, Wot, Wot, Wot, Wot, Wot, Wwt, Wwt, Ds, Ds, Hhd, Ds, Hhd, Ds, Hd, Dd^Es, Dd, Hhd, Mv, Hhd, Hhd, Hhd, Wwrt, Wwrt, Wot, Wot, Wot, Wot, Wot, Wot, Wot, Wot, Wot, Wot, Wot, Wot, Wot, Wot, Wot, Wot, Wot, Wot, Wot, Wot, Wot, Wot, Wot, Wot, Wot, Wot, Wot
Wot, Wot, Wot, Wot, Wot, Wot, Hhd, Mdd, Hhd, Wot, Wot, Wot, Wot, Wot, Wot, Wwrt, Wot, Wot, Wot, Wot, Wot, Wot, Wwt, Wwt, Ds, Hhd, Hhd, Hhd, Gd^Es, Hhd, Hhd, Hhd, Hhd, Md, Md, Md, Hhd, Wwt, Wwt, Wwt, Wot, Wot, Wot, Wot, Wot, Wot, Wot, Wot, Wot, Wot, Wot, Wot, Wot, Wot, Wot, Wot, Wot, Wot, Wot, Wot, Wot, Wot, Wot, Wot, Wot, Wot, Wot
Wot, Wot, Wot, Wot, Wot, Wwrt, Hhd, Mdd, Hhd, Wwrt, Wwrt, Wot, Wot, Wot, Wot, Wwrt, Wot, Wot, Wot, Wot, Wwt, Wwt, Ds, Ds, Hhd, Hhd, Ds, Gd, Ds, Hhd, Ds, Hhd, Hd, Hhd, Hhd, Hhd, Wwrt, Wwrt, Wwt, Wot, Wot, Wot, Wot, Wot, Wot, Wot, Wot, Wot, Wot, Wot, Wot, Wot, Wot, Wot, Wot, Wot, Wot, Wot, Wot, Wot, Wot, Wot, Wot, Wot, Wot, Wot, Wot
Wot, Wot, Wot, Wot, Wot, Wwrt, Wot, Hhd, Ds, Hhd, Wot, Wot, Wot, Wot, Wot, Wot, Wot, Wot, Wot, Wot, Wot, Wwt, Wwt, Wwt, Wwt, Ds, Wwt, Ds, Wwt, Ds, Wwt, Wwrt, Wwt, Hd, Wwrt, Wwt, Wwt, Wwt, Wot, Wot, Wot, Wot, Wot, Wot, Wot, Wot, Wot, Wot, Wot, Wot, Wot, Wot, Wot, Wot, Wot, Wot, Wot, Wot, Wot, Wot, Wot, Wot, Wot, Wot, Wot, Wot, Wot
Wot, Wot, Wot, Wot, Wot, Wot, Wot, Ds, Ds, Wot, Wot, Wot, Wot, Wot, Wot, Wot, Wot, Wot, Wot, Wot, Wot, Wwt, Wot, Wot, Wot, Wwt, Wot, Wwt, Wwt, Wwt, Wot, Wwt, Wot, Wwrt, Wwt, Wot, Wot, Wot, Wot, Wot, Wot, Wot, Wot, Wot, Wot, Wot, Wot, Wot, Wot, Wot, Wot, Wot, Wot, Wot, Wot, Wot, Wot, Wot, Wot, Wot, Wot, Wot, Wot, Wot, Wot, Wot, Wot
Wot, Wot, Wot, Wot, Wot, Wot, Wot, Wot, Wot, Wwrt, Wot, Wot, Wot, Wot, Wot, Wot, Wot, Wot, Wot, Wot, Wot, Wot, Wot, Wot, Wot, Wot, Wot, Wot, Wot, Wot, Wot, Wot, Wot, Wot, Wot, Wot, Wot, Wot, Wot, Wot, Wot, Wot, Wot, Wot, Wot, Wot, Wot, Wot, Wot, Wot, Wot, Wot, Wot, Wot, Wot, Wot, Wot, Wot, Wot, Wot, Wot, Wot, Wot, Wot, Wwt, Wot, Wot
Wot, Wot, Wot, Wot, Wot, Wot, Wot, Wot, Wot, Wot, Wot, Wot, Wot, Wot, Wot, Wot, Wot, Wot, Wot, Wot, Wot, Wot, Wot, Wot, Wot, Wot, Wot, Wot, Wot, Wot, Wot, Wot, Wot, Wot, Wot, Wot, Wot, Wot, Wot, Wot, Wot, Wot, Wot, Wot, Wot, Wot, Wwt, Wot, Wwt, Wot, Wot, Wot, Wot, Wot, Wot, Wot, Wot, Wot, Wot, Wot, Wot, Wwt, Wwt, Wwt, Wwt, Wot, Wot
Wot, Wot, Wot, Wot, Wot, Wot, Wot, Wot, Wot, Wot, Wot, Wot, Wot, Wot, Wot, Wot, Wot, Wot, Wot, Wot, Wot, Wot, Wot, Wot, Wot, Wot, Wot, Wot, Wot, Wot, Wot, Wot, Wot, Wot, Wot, Wot, Wot, Wot, Wot, Wot, Wot, Wot, Wot, Wot, Wwt, Wwt, Wwt, Wwt, Wwt, Wwt, Wwt, Wot, Wot, Wot, Wot, Wot, Wot, Wot, Wot, Wot, Wot, Wwt, Wwt, Wwt, Wwt^Es, Wot, Wot
Wot, Wot, Wot, Wot, Wot, Wot, Wot, Wot, Wot, Wot, Wot, Wot, Wot, Wot, Wot, Wot, Wot, Wot, Wot, Wot, Wot, Wot, Wot, Wot, Wot, Wot, Wot, Wot, Wot, Wot, Wot, Wot, Wot, Wot, Wot, Wot, Wot, Wot, Wot, Wot, Wot, Wot, Wot, Wot, Wwt, Wwt, Gs, Ds, Ds, Wwt, Wwt, Wot, Wot, Wot, Wot, Wot, Wot, Wot, Wot, Wot, Wwt, Wwt, Ds, Ds, Wwt, Wwt, Wot
Wot, Wot, Wot, Wot, Wot, Wot, Wot, Wot, Wot, Wot, Wot, Wot, Wot, Wot, Wot, Wot, Wwt, Wot, Wwt, Wwt, Wwt, Wwt, Wot, Wot, Wot, Wot, Wot, Wot, Wot, Wot, Wot, Wot, Wot, Wot, Wot, Wot, Wot, Wot, Wot, Wot, Wot, Wot, Wot, Wot, Wwt, Wwt, Gs, Ds, Ds, Wwt, Wot, Wot, Wot, Wot, Wot, Wot, Wot, Wot, Wot, Wwt, Wwt^Es, Ds, Hd, Ds, Wwt, Wwt, Wot
Wot, Wot, Wot, Wot, Wot, Wot, Wot, Wot, Wot, Wot, Wot, Wot, Wot, Wot, Wot, Wot, Wwt, Wwt, Ds, Wwt, Ds, Wwt, Wwt, Wot, Wot, Wot, Wot, Wot, Wot, Wot, Wot, Wot, Wot, Wot, Wot, Wot, Wot, Wot, Wot, Wot, Wot, Wot, Wwt, Wwt, Gs^Ft, Gs^Ft, Gs, Ds, Ds, Wwt, Wot, Wot, Wot, Wot, Wot, Wot, Wot, Wot, Wwt, Wwt^Es, Ds, Dd, Ds, Ds, Wwt, Wot, Wot
Wot, Wot, Wot, Wot, Wot, Wot, Wot, Wot, Wot, Wot, Wot, Wot, Wot, Wot, Wot, Wwt, Ds, Ds, Gs, Ds, Ds, Wwt, Wwt, Wot, Wot, Wot, Wot, Wot, Wot, Wot, Wot, Wot, Wot, Wot, Wot, Wot, Wot, Wot, Wot, Wot, Wwt, Wwt, Gs^Ft, Gs^Ft, Gs^Ft, Gs^Es, Ds, Ds, Wwt, Wwt, Wot, Wot, Wot, Wot, Wot, Wwt, Wot, Wot, Wot, Wwt, Wwt, Wwt, Wwt, Wwt^Es, Wwt, Wot, Wot
Wot, Wot, Wot, Wot, Wot, Wot, Wot, Wot, Wot, Wot, Wot, Wot, Wot, Wot, Wwt, Wwt, Ds, Ds, Gs, Gs, Gs, Ds, Wwt, Wwt, Wot, Wot, Wot, Wot, Wot, Wot, Wot, Wot, Wot, Wot, Wot, Wot, Wot, Wot, Wot, Wot, Wwt, Wwt, Gs^Ft, Gs^Ft, Hh^Ft, Gs^Ft, Ds, Wwt, Wwt, Wot, Wwrt, Wot, Wot, Wot, Wwt, Wwt, Wwrt, Wwrt, Wot, Wwt, Wwrt, Wot, Wwt, Wwt, Wot, Wot, Wot
Wot, Wot, Wot, Wot, Wot, Wot, Wot, Wot, Wot, Wot, Wot, Wot, Wot, Wot, Wwt, Wwt, Ds, Gs, Gs, Gs, Ds, Ds, Wwt, Wwt, Wot, Wot, Wot, Wot, Wot, Wot, Wot, Wot, Wot, Wot, Wot, Wot, Wot, Wot, Wot, Wwt, Wwt, Gs^Ft, Gs^Ft, Hh^Ft, Gs^Es, Gs^Ft, Gs, Ds, Wwt, Wwt, Wwrt, Wwrt, Wwt, Wot, Wwt, Wwt, Wwt, Wot, Wot, Wot, Wot, Wot, Wot, Wot, Wot, Wot, Wot
Wot, Wot, Wot, Wot, Wot, Wot, Wot, Wot, Wot, Wot, Wot, Wot, Wot, Wot, Wwt, Ds, Gs^Ft, Gs, Gs^Ft, Gs, Ds, Wwt, Wwrt, Wot, Wot, Wot, Wot, Wot, Wot, Wot, Wot, Wot, Wot, Wot, Wot, Wot, Wot, Wot, Wot, Wwt, Wwt, Gs^Ft, Gs^Ft, Gs^Ft, Gs^Ft, Gs^Ft, Gs^Ft, Ds, Ds, Ds, Ds, Wwt, Wwt, Wot, Wot, Wot, Wot, Wot, Wot, Wot, Wot, Wot, Wot, Wot, Wot, Wot, Wot
Wot, Wot, Wot, Wot, Wot, Wot, Wot, Wot, Wot, Wot, Wot, Wot, Wwt, Wwt, Ds, Ds, Gs^Ft, Gs, Gs^Es, Gs, Ds, Wwt, Wwt, Wwrt, Wot, Wot, Wot, Wot, Wot, Wot, Wot, Wot, Wot, Wot, Wot, Wot, Wot, Wot, Wot, Wot, Wwt, Wwt, Wwt, Gs^Ft, Wwt, Gs^Ft, Gs^Ft, Gs^Es, Gs, Gs, Ds, Ds, Wwt, Wwrt, Wot, Wot, Wot, Wot, Wot, Wot, Wot, Wot, Wot, Wot, Wot, Wot, Wot
Wot, Wot, Wot, Wot, Wot, Wot, Wot, Wot, Wot, Wot, Wwt, Wwt, Ds, Ds, Hh, Gs^Ft, Hh, Gs^Es, Gs, Ds, Wwt, Wwt, Wwt, Wwrt, Wwrt, Wot, Wot, Wot, Wot, Wot, Wot, Wot, Wot, Wot, Wot, Wot, Wot, Wot, Wot, Wot, Wot, Wwt, Wot, Wwt, Gs^Ft, Gs^Ft, Gs^Ft, Gs^Ft, Ds, Ds, Ds, Wwt, Wwrt, Wwrt, Wot, Wot, Wot, Wot, Wot, Wot, Wot, Wot, Wot, Wot, Wot, Wot, Wot
Wot, Wot, Wot, Wot, Wot, Wot, Wot, Wot, Wot, Wot, Wot, Wwt, Ds, Gs, Hh, Hh, Hh, Gs^Ft, Ds, Ds, Wwt, Wwt, Wwt, Wwt, Wwt, Wot, Wot, Wot, Wot, Wot, Wot, Wot, Wot, Wot, Wot, Wot, Wot, Wot, Wot, Wot, Wot, Wot, Wwt, Wwt, Ds, Gs^Ft, Ds, Ds, Ds, Ds, Wwt, Wwt, Wwt, Wot, Wot, Wot, Wot, Wot, Wot, Wot, Wot, Wot, Wot, Wot, Wot, Wot, Wot
Wot, Wot, Wot, Wot, Wot, Wot, Wot, Wot, Wot, Wot, Wot, Wwt, Wwt, Ds, Ds, Hh, Hh, Gs^Ft, Ds, Wwt, Wwt, Wwt, Wwt, Wwt, Wwt, Wwrt, Wwrt, Wot, Wot, Wot, Wot, Wot, Wot, Wot, Wot, Wot, Wot, Wot, Wot, Wot, Wot, Wot, Wot, Wwt, Wwt, Ds, Wwt, Ds, Wwrt, Wwrt, Wwt, Wwrt, Wot, Wot, Wot, Wot, Wot, Wot, Wot, Wot, Wot, Wot, Wot, Wot, Wot, Wot, Wot
Wot, Wot, Wot, Wot, Wot, Wot, Wot, Wot, Wot, Wot, Wot, Wot, Wot, Wwrt, Hh, Hh, Hh, Hh, Hh^Ft, Ds, Ds, Ds, Ds, Wwt, Wwt, Wwrt, Wwt, Wwt, Wwt, Wwt, Wwt, Wot, Wot, Wot, Wot, Wot, Wot, Wot, Wot, Wot, Wot, Wot, Wot, Wwt, Wwt, Wwt, Wwt, Wwt, Wwt, Wwt, Wwt, Wwrt, Wot, Wot, Wot, Wot, Wot, Wot, Wot, Wot, Wot, Wot, Wot, Wot, Wot, Wot, Wot
Wot, Wot, Wot, Wot, Wot, Wot, Wot, Wot, Wot, Wot, Wot, Wot, Wwrt, Wwrt, Hh, Hh, Mm, Mm, Mm, Hh^Ft, Gs^Ft, Gs, Gs, Wwt, Mm, Wwt, Mm, Mm, Mm, Wwrt, Wwt, Wot, Wot, Wot, Wot, Wot, Wot, Wot, Wot, Wot, Wot, Wot, Wot, Wot, Wot, Wwt, Wot, Wot, Wot, Wot, Wot, Wot, Wot, Wot, Wot, Wot, Wot, Wot, Wot, Wot, Wot, Wot, Wot, Wot, Wot, Wot, Wot
Wot, Wot, Wot, Wot, Wot, Wot, Wot, Wot, Wot, Wot, Wot, Wot, Wwt, Hh, Hh, Mm, Mm, Mm, Hh^Ft, Gs^Ft, Gs^Ft, Mm, Mm, Mm, Mm, Mm, Wwrt, Mm, Wwt, Wwt, Wot, Wot, Wot, Wot, Wot, Wot, Wwt, Wot, Wwt, Wwt, Wot, Wot, Wot, Wot, Wot, Wot, Wot, Wot, Wot, Wot, Wot, Wot, Wot, Wot, Wot, Wot, Wot, Wot, Wwrt, Wot, Wot, Wot, Wot, Wot, Wot, Wot, Wot
Wot, Wot, Wot, Wot, Wot, Wot, Wot, Wot, Wot, Wot, Wot, Wwt, Wwt, Hh, Mm, Mm, Hh^Ft, Hh^Ft, Mm, Gs^Ft, Mm, Mm, Mm, Mm, Wwt, Wwrt, Wwt, Wwt, Wwt, Wwt, Wot, Wot, Wot, Wot, Wwt, Wwt, Hhd, Wwt, Hhd, Wwrt, Wot, Wot, Wot, Wot, Wot, Wot, Wot, Wot, Wot, Wot, Wot, Wot, Wot, Wot, Wot, Wot, Wot, Wot, Wwrt, Mm, Wwrt, Wwrt, Wwrt, Wot, Wwrt, Wwrt, Wwrt
Wot, Wot, Wot, Wot, Wot, Wot, Wot, Wot, Wot, Wot, Wot, Wwt, Wwt, Mm, Wwrt, Mm, Mm, Mm, Mm, Mm, Mm, Mm, Wwrt, Mm, Wwt, Wwt, Wot, Wwt, Wot, Wot, Wot, Wot, Wot, Wwt, Wwt, Ds, Mdd, Mdd, Hhd, Wwrt, Wwt, Wot, Wot, Wot, Wot, Wot, Wot, Wot, Wot, Wot, Wot, Wot, Wot, Wot, Wot, Wot, Wot, Wot, Mm, Mm, Mm, Mm, Wwrt, Wot, Mm, Mm, Mm
Wot, Wot, Wot, Wot, Wot, Wot, Wot, Wot, Wot, Wot, Wot, Wot, Wot, Wwrt, Wwt, Wwt, Mm, Mm, Wwrt, Wwrt, Wwt, Wwt, Wot, Wwt, Wot, Wot, Wot, Wot, Wot, Wot, Wot, Wot, Wot, Wot, Wwt, Ds, Hhd, Hhd, Wwt, Wwt, Wot, Wot, Wot, Wot, Wot, Wot, Wot, Wot, Wot, Wot, Wot, Wot, Wot, Wot, Wot, Wot, Wwrt, Wwrt, Mm, Mm, Hhd, Hhd, Hhd, Mm, Mm, Mm, Mm
Wot, Wot, Wot, Wot, Wot, Wot, Wot, Wot, Wot, Wot, Wot, Wot, Wwt, Wwt, Mm, Mm, Wwt, Wwrt, Wot, Wot, Wot, Wot, Wot, Wot, Wot, Wot, Wot, Wot, Wot, Wot, Wot, Wot, Wot, Wot, Wot, Wwt, Wwt, Wwt, Wwt, Wot, Wot, Wot, Wot, Wot, Wot, Wot, Wot, Wot, Wot, Wot, Wot, Wot, Wot, Wot, Wot, Wot, Hhd, Hhd, Hhd, Hhd, Mm, Hhd, Hhd, Mm, Hhd, Hhd, Mm
Wot, Wot, Wot, Wot, Wot, Wot, Wot, Wot, Wot, Wot, Wot, Wot, Wwt, Wwt, Wwt, Wwt, Wot, Wot, Wot, Wot, Wot, Wot, Wot, Wot, Wot, Wot, Wot, Wot, Wot, Wot, Wot, Wot, Wot, Wot, Wot, Wot, Wot, Wot, Wot, Wot, Wot, Wot, Wot, Wot, Wot, Wot, Wot, Wot, Wot, Wot, Wot, Wot, Wot, Wot, Wot, Wot, Wwt, Wwrt, Ds, Gd^Fts, Gd^Fts, Hhd, Hhd, Hhd, Hhd, Hhd, Mm
Wot, Wot, Wot, Wot, Wot, Wot, Wot, Wot, Wot, Wot, Wot, Wot, Wot, Wot, Wot, Wot, Wot, Wot, Wot, Wot, Wot, Wot, Wot, Wot, Wot, Wot, Wot, Wot, Wot, Wot, Wot, Wot, Wot, Wot, Wot, Wot, Wot, Wot, Wot, Wot, Wot, Wot, Wot, Wot, Wot, Wot, Wot, Wot, Wot, Wot, Wot, Wot, Wwt, Wwt, Wwt, Wwt, Ds, Ds, Gd, Gd^Fts, Hhd, Hhd, Gd^Fts, Gd^Fts, Hhd, Hhd, Hhd
Wot, Wot, Wot, Wot, Wot, Wot, Wot, Wot, Wot, Wot, Wot, Wot, Wot, Wot, Wot, Wot, Wot, Wot, Wot, Wot, Wot, Wot, Wot, Wot, Wot, Wot, Wot, Wot, Wot, Wot, Wot, Wot, Wot, Wot, Wot, Wot, Wot, Wot, Wot, Wot, Wot, Wot, Wot, Wot, Wot, Wot, Wot, Wot, Wot, Wot, Wot, Wot, Wwt, Wwt, Ds, Wwt, Ds, Ds, Gd^Fts, Gd^Fts, Gd^Fts, Gd, Gd, Gd, Hhd, Hhd, Hhd
Wot, Wot, Wot, Wot, Wot, Wot, Wot, Wot, Wot, Wot, Wot, Wot, Wot, Wot, Wot, Wot, Wot, Wot, Wot, Wot, Wot, Wot, Wot, Wot, Wot, Wot, Wot, Wot, Wot, Wot, Wot, Wot, Wot, Wot, Wot, Wot, Wot, Wot, Wot, Wot, Wot, Wot, Wot, Wot, Wot, Wot, Wot, Wot, Wot, Wot, Wwt, Wwt, Ds, Ds, Ds, Ds, Ds, Gd, Gd, Gd^Fts, Gd, Gd, Gd, Gd^Fts, Hhd, Hhd, Hhd
Wot, Wot, Wot, Wot, Wot, Wot, Wot, Wot, Wot, Wot, Wot, Wot, Wot, Wot, Wot, Wot, Wot, Wot, Wot, Wot, Wot, Wot, Wot, Wot, Wot, Wot, Wot, Wot, Wot, Wot, Wot, Wot, Wot, Wot, Wot, Wot, Wot, Wot, Wot, Wot, Wot, Wot, Wot, Wot, Wot, Wot, Wot, Wot, Wot, Wot, Wwt, Wwt, Ds, Ds, Ds, Ds, Gd, Gd, Gd, Gd, Gd^Fts, Gd^Fts, Gd, Hhd, Gd, Hhd, Ds
Wot, Wot, Wot, Wot, Wot, Wot, Wot, Wot, Wot, Wot, Wot, Wot, Wot, Wot, Wot, Wot, Wot, Wot, Wot, Wot, Wot, Wot, Wot, Wot, Wot, Wot, Wot, Wot, Wot, Wot, Wot, Wot, Wot, Wot, Wot, Wot, Wot, Wot, Wot, Wot, Wot, Wot, Wot, Wot, Wot, Wot, Wot, Wot, Wot, Wot, Wot, Wwt, Wwt, Wwt, Ds, Ds, Gd^Fts, Gd^Fts, Gd, Ds, Gd, Gd, Ds, Gd, Ds, Ds, Wwt
Wot, Wot, Wot, Wot, Wot, Wot, Wot, Wot, Wot, Wot, Wot, Wot, Wot, Wot, Wot, Wot, Wot, Wot, Wot, Wot, Wot, Wot, Wot, Wot, Wot, Wot, Wot, Wot, Wot, Wot, Wot, Wot, Wot, Wot, Wot, Wot, Wot, Wot, Wot, Wot, Wot, Wot, Wot, Wot, Wot, Wot, Wot, Wot, Wot, Wot, Wot, Wot, Wwt, Wwt, Ds, Ds, Gd^Fts, Gd^Fts, Ds, Ds, Ds, Ds, Ds, Ds, Wwt, Wwt, Wwt
Wot, Wot, Wot, Wot, Wot, Wot, Wot, Wot, Wot, Wot, Wot, Wot, Wot, Wot, Wot, Wot, Wot, Wot, Wot, Wot, Wot, Wot, Wot, Wot, Wot, Wot, Wot, Wot, Wot, Wot, Wwt, Wot, Wwt, Wot, Wot, Wot, Wot, Wot, Wot, Wot, Wot, Wot, Wot, Wot, Wot, Wot, Wot, Wot, Wot, Wot, Wot, Wwt, Wwt, Ds, Ds, Gd, Ds, Ds, Ds, Wwt, Wwt, Wwt, Wwt, Wwt, Wwt, Wwt, Wwt
Wot, Wot, Wot, Wot, Wot, Wot, Wot, Wot, Wot, Wot, Wot, Wot, Wot, Wot, Wot, Wot, Wot, Wot, Wot, Wot, Wot, Wot, Wwt, Wot, Wwt, Wwt, Wwt, Wwt, Wwt, Wwt, Wwt, Wwt, Wwt, Wwt, Wwt, Wot, Wot, Wot, Wot, Wot, Wot, Wot, Wot, Wot, Wot, Wot, Wot, Wot, Wot, Wot, Wot, Wwt, Wwt, Ds, Ds, Ds, Ds, Ds, Wwt, Wwt, Wot, Wot, Wot, Wot, Wot, Wot, Wot
Wot, Wot, Wot, Wot, Wot, Wot, Wot, Wot, Wot, Wot, Wot, Wot, Wot, Wot, Wot, Wot, Wwt, Wot, Wwt, Wwt, Wwt, Wwt, Wwt, Wwt, Wwt, Wwt, Wwt, Wwt, Wwt, Wwt, Wwt, Wwt, Wwt, Wwt, Wwt, Wwt, Wwt, Wot, Wot, Wot, Wot, Wot, Wot, Wot, Wot, Wot, Wot, Wot, Wwrt, Wot, Wot, Wwt, Wot, Wwt, Ds, Ds, Ds, Wwt, Wwt, Wwt, Wot, Wot, Wot, Wot, Wot, Wot, Wot
Wot, Wot, Wot, Wot, Wot, Wot, Wot, Wot, Wot, Wot, Wot, Wot, Wot, Wot, Wwt, Wwt, Wwt, Wwt, Wwt, Wwt, Wwt, Wwt, Wwt, Wwt, Wwt, Wwt, Ds^Ewsh, Wwt, Ds, Wwt, Ds, Wwt, Ds^Ewsh, Wwt, Wwt, Wwt, Wwt, Wot, Wot, Wot, Wot, Wot, Wot, Wot, Wot, Wot, Wot, Wot, Wwrt, Wwt, Wot, Wot, Wwt, Wwt, Ds, Ds, Wwt, Wwt, Wwt, Wot, Wot, Wot, Wot, Wot, Wot, Wot, Wot
Wot, Wot, Wot, Wot, Wot, Wot, Wot, Wot, Wot, Wot, Wwt, Wot, Wwt, Wwt, Wwt, Wwt, Wwt, Wwt, Ds^Ewsh, Wwt, Ds, Ds, Ds, Wwt, Ds^Ewsh, Ds^Ewsh, Ds, Ds, Ds^Ewsh, Ds, Ds, Ds, Ds, Ds^Ewsh, Ds^Ewsh, Wwt, Wwt, Wwt, Wwt, Wot, Wot, Wot, Wot, Wot, Wwrt, Wot, Wot, Wwt, Wot, Wwt, Wot, Wot, Wwt, Ds, Wwt, Wwt, Wwrt, Wwt, Wot, Wot, Wot, Wot, Wot, Wot, Wot, Wot, Wot
Wot, Wot, Wot, Wot, Wot, Wot, Wot, Wot, Wot, Wot, Wwt, Wwt, Wwt, Wwt, Ds, Ds, Ds, Ds^Ewsh, Ds, Ds, Ds, Ds, Gs^Ft, Ds, Dd, Ds, Gs^Ft, Dd, Gs, Gs, Gs^Ft, Gd, Gd, Ds, Ds^Ewsh, Wwt, Wwt, Wwt, Wwt, Wot, Wot, Wot, Wot, Wot, Wwrt, Wwrt, Wot, Wot, Wot, Wot, Wot, Wot, Wwt, Ds, Wwt, Wwt, Wot, Wot, Wot, Wot, Wot, Wot, Wot, Wot, Wot, Wot, Wot
Wot, Wot, Wot, Wot, Wot, Wot, Wot, Wot, Wwt, Wwt, Wwt, Wwt, Wwt, Ds^Ewsh, Ds, Ds, Ds, Ds, Gs^Ft, Gs^Ft, Gs^Ft, Gs^Ft, Gs^Vht, Gs^Ft, Gs^Ft, Gs^Ft, Gs^Ft, Gs^Ft, Gs^Ft, Gs^Ft, Gs^Ft, Gs^Ft, Gd, Gd, Dd, Ds, Wwt, Wwt, Wwt, Wot, Wot, Wot, Wwt, Wwrt, Wwt, Ds, Wwt, Wot, Wot, Wot, Wot, Ds, Wwt, Wwt, Wwrt, Wwt, Wot, Wot, Wot, Wot, Wot, Wot, Wot, Wot, Wot, Wot, Wot
Wot, Wot, Wot, Wot, Wot, Wot, Wot, Wot, Wwt, Wwt, Wwt, Wwt, Ds, Ds, Gs^Ft, Gs^Ft, Gs^Ft, Gs^Ft, Gs^Ft, Gs^Ft, Gs^Ft, Gs^Ft, Gs^Ft, Gs^Ft, Gs^Ft, Gs^Ft, Gs^Ft, Gs^Ft, Gs^Ft, Gs^Ft, Gs^Ft, Gs^Ft, Gs^Ft, Gd, Ds^Ewsh, Ds, Wwt, Wwt, Wwt, Wwrt, Ds, Wot, Wwt, Wwt, Wot, Wwt, Wot, Wot, Wwrt, Wwrt, Wot, Wwt, Wot, Wwrt, Wot, Wot, Wot, Wot, Wot, Wot, Wot, Wot, Wot, Wot, Wot, Wot, Wot
Wot, Wot, Wot, Wot, Wot, Wot, Wot, Wot, Wwt, Wwt, Wwt, Wwt, Ds, Gs^Ft, Gs^Ft, Gs^Ft, Gs^Ft, Gs^Ft, Gs^Ft, Gs^Ft, Gs^Ft, Gs^Ft, Gll^Ftr, Gs^Ft, Gs^Ft, Gs^Ft, Gs^Ft, Gs^Ft, Gs^Ft, Gs^Ft, Gs^Ft, Gs^Ft, Gs^Ft, Ds, Ds^Ewsh, Wwt, Wwt, Wwt, Wwrt, Wwrt, Ds, Ds, Ds, Wot, Wot, Wot, Wot, Wot, Wot, Wwt, Wot, Wot, Wot, Wot, Wot, Wot, Wot, Wot, Wot, Wot, Wot, Wot, Wot, Wot, Wot, Wot, Wot
Wot, Wot, Wot, Wot, Wot, Wot, Wwt, Wwt, Wwt, Wwt, Ds, Ds, Gs^Ft, Gs^Ft, Gs^Ft, Gs^Ft, Gll^Ftr, Gll^Ftr, Gs^Ft, Gll^Ftr, Gll^Ftr, Gll^Ftr, Gll^Ftr, Gs^Ft, Gs^Ft, Gs^Ft, Gs^Ft, Gs^Ft, Gs^Ft, Gs^Ft, Gs^Ft, Gs^Ft, Gd, Ds, Ds^Ewsh, Wwt, Wwt, Wwt, Wwrt, Ds, Wot, Ds, Wot, Wot, Wwt, Wwrt, Wwt, Wot, Wot, Wot, Wot, Wot, Wot, Wot, Wot, Wot, Wot, Wot, Wot, Wot, Wot, Wot, Wot, Wot, Wot, Wot, Wot
Wot, Wot, Wot, Wot, Wot, Wot, Wwt, Wwt, Wwt, Ds, Ds, Ds, Gs^Ft, Gs^Ft, Gs^Vht, Gs^Ft, Gs^Ft, Gs^Ft, Gs^Ft, Gs^Ft, Gll^Ftr, Gll^Ftr, Gll^Ftr, Gll^Ftr, Hh^Ft, Gs^Ft, Gs^Ft, Gs^Ft, Gs^Ft, Gs^Ft, Gs^Ft, Gs^Ft, Gd, Gd, Ds, Ds, Wwt, Wwt, Wwt, Wwrt, Wot, Wot, Wot, Wwt, Wwrt, Wwrt, Wwt, Wot, Wot, Wot, Wot, Wot, Wot, Wot, Wot, Wot, Wot, Wot, Wot, Wot, Wot, Wot, Wot, Wot, Wot, Wot, Wot
Wot, Wot, Wot, Wot, Wot, Wwt, Wwt, Wwt, Ds, Ss, Ds, Gs, Gs^Ft, Gs^Ft, Gs^Ft, Gs^Ft, Gs^Ft, Hh, Hh^Ft, Hh^Ft, Hh^Ft, Wwt, Wwt, Hh^Ft, Gs^Ft, Gs^Ft, Hh^Ft, Hh^Ft, Gs^Ft, Gs^Vht, Gs, Gs^Ft, Gd, Gd, Ds, Ds^Ewsh, Wwt, Wwt, Wwt, Wot, Wot, Wot, Ds, Wwt, Wwt, Wwt, Wwrt, Wot, Wot, Wot, Wot, Wot, Wot, Wot, Wot, Wot, Wot, Wot, Wot, Wot, Wot, Wot, Wot, Wot, Wot, Wot, Wot
Wot, Wot, Wot, Wot, Wwt, Wwt, Wwt, Wwt, Ss, Ds, Gs, Gs^Efm, Ss, Gs^Ft, Gs^Ft, Gs^Ft, Hh^Ft, Hh^Ft, Hh^Ft, Hh^Ft, Hh^Ft, Wwrt, Hh^Ft, Wwt, Hh, Hh, Hh^Ft, Hh^Ft, Gs^Ft, Gs, Gd, Gd, Dd, Dd, Ds, Wwt, Wwt, Wwt, Wot, Wot, Wot, Ds, Wwrt, Wwt, Wot, Wwt, Wot, Wot, Wot, Wot, Wot, Wot, Wot, Wot, Wot, Wot, Wot, Wot, Wot, Wot, Wot, Wot, Wot, Wot, Wot, Wot, Wot
Wot, Wot, Wot, Wwt, Wwt, Wwt, Wwt, Ss, Ss, Ds, Gll^Ftr, Ss, Gll^Ftr, Gs^Ft, Gs^Ft, Hh, Hh, Hh^Ft, Hh^Ft, Hh^Ft, Hhd, Hhd^Ft, Hh^Ft, Hh^Ft, Hh^Ft, Hh^Ft, Hh^Ft, Hh^Ft, Gs, Gs, Ds, Gd, Ds, Ds^Ewsh, Wwt, Wwt, Wwrt, Wwrt, Wot, Wot, Wot, Wot, Wot, Wot, Wot, Wot, Wot, Wot, Wot, Wot, Wot, Wot, Wot, Wot, Wot, Wot, Wot, Wot, Wot, Wot, Wot, Wot, Wot, Wot, Wot, Wot, Wot
Wot, Wot, Wwt, Wwt, Wwt, Wwt, Ss, Wwt, Ww^Vm, Ss, Gll^Ftr, Gll^Ftr, Ss, Wwt, Hh^Ft, Hh^Ft, Hh^Ft, Hh^Ft, Hh, Hhd, Hhd, Hhd^Ft, Hh^Ft, Hh^Ft, Hh^Ft, Hh^Ft, Hh^Ft, Hh^Ft, Gd, Ds^Ewsh, Ds^Ewsh, Ds^Ewsh, Wwt, Wwt, Wwt, Wwt, Wwrt, Wot, Wot, Wot, Wot, Wot, Wot, Wot, Wot, Wot, Wot, Wot, Wot, Wot, Wot, Wot, Wot, Wot, Wot, Wot, Wot, Wot, Wot, Wot, Wot, Wot, Wot, Wot, Wot, Wot, Wot
Wot, Wot, Wwt, Wwt, Wwt, Ss, Ds, Ss, Ss, Ss, Ss, Gll^Ftr, Ss, Ss, Hh^Ft, Hh^Ft, Hh^Ft, Hh, Hhd^Ft, Hhd^Vc, Hhd, Hhd^Ft, Hhd^Ft, Hh, Hh, Hh^Ft, Hh^Ft, Gd, Dd, Ds^Ewsh, Wwrt, Wwrt, Wwt, Wwrt, Wot, Wot, Wot, Wot, Wot, Wot, Wot, Wot, Wot, Wot, Wot, Wot, Wot, Wot, Wot, Wot, Wot, Wot, Wot, Wot, Wot, Wot, Wot, Wot, Wot, Wot, Wot, Wot, Wot, Wot, Wot, Wot, Wot
Wwt, Wwt, Wwt, Wwt, Ds, Ds, Ss, Ds, Gll^Ftr, Gll^Ftr, Gll^Ftr, Wwt, Wwt, Wwt, Wwt, Hh^Ft, Hh^Ft, Hh, Hh^Ft, Hhd, Hhd, Hhd^Ft, Mm, Hh, Hh, Hh, Hh^Ft, Dd, Wwt, Ds^Ewsh, Wwt, Wwt, Wwrt, Wwrt, Wot, Wot, Wot, Wot, Wot, Wot, Wot, Wot, Wot, Wot, Wot, Wot, Wot, Wot, Wot, Wot, Wot, Wot, Wot, Wot, Wot, Wot, Wot, Wot, Wot, Wot, Wot, Wot, Wot, Wot, Wot, Wot, Wot
