Ww, Ww, Ww, Ww, Ww, Ww, Ww, Wo, Ww, Wo, Wo, Wo, Wo, Wo, Wo, Wo, Wo, Wo, Wo, Wo, Ww, Ww, Wo, Wo, Ww, Wo, Wwr, Wwr, Wo, Wo, Wo, Wo, Wo
Ww, Ww, Ds, Ds, Ds, Ww, Ds, Ww, Ds, Ww, Ww, Wo, Wo, Wo, Wo, Wo, Wo, Wo, Ww, Ww, Gs^Ftp, Ww, Ww, Ww, Ww, Ww, Ww, Wwr, Wwr, Wwr, Wo, Wo, Wo
Ww, Ds, Gs^Vht, Gs^Ftp, Ds, Ds, Ds, Gs^Vht, Gs^Ftp, Ds, Ww, Wo, Ww, Wo, Ww, Wo, Wo, Ww, Ww, Gs^Ftp, Gs^Vht, Gs^Ftp, Gs^Ftp, Gs^Ftp, Gs^Vht, Gs^Ftp, Gs^Ftp, Ww, Wwr, Wwr, Wwr, Wo, Wo
Ww, Ds, Gs^Ftp, Ds, Ww^Vm, Ww, Ww, Ds, 4 Kme, Ds, Ds, Ww, Ww, Ww, Ds, Ww, Ww, Ww, Ww, Ds, Ds, Gs^Ftp, Ds, Gs^Ftp, Ds, Ds, Gs^Ftp, Ww, Ww, Wwr, Wwr, Wo, Wo
Ww, Ds, Ds, Ds, Ds, Ww, Ww, Cme, Cme, Cme, Ww, Ww, Ww, Ds, Ww, Ds, Ww, Ww, Ds, Ds, Ds, Ds, Ww, Ds, Ww^Vm, Ds, Ds, Ds, Ww, Ww, Wwr, Wwr, Wo
Wo, Ww, Ww, Ww, Ww, Ds, Ww, Wo, Wo, Wo, Wo, Wo, Ww, Ww, Wo, Ww, Ww, Ww, Ds, Ds, Ww, Ww, Ww, Ww, Ww, Ww, Ds, Ds, Ds, Ww, Ww, Wwr, Wo
Wo, Wo, Wo, Wo, Wo, Ww, Wo, Wo, Wo, Wo, Wo, Wo, Wo, Wo, Wo, Wo, Ww, Ww, Ww, Ww, Wo, Wo, Wo, Wo, Ww, Ww, Ds, Ds, Ww, Ww, Wwr, Wwr, Wo
Wo, Wo, Wo, Wo, Wo, Wo, Wo, Wo, Wo, Wo, Wo, Wo, Wo, Wo, Wo, Wo, Wo, Ww, Wo, Wo, Wo, Wo, Wo, Ww, Ww, Ww, Ds, Ds, Ww, Ww, Wwr, Wo, Wo
Wwr, Wo, Wwr, Wo, Wwr, Wo, Wo, Wo, Wo, Wo, Wo, Wo, Wo, Wo, Wo, Wo, Wo, Wo, Wo, Wo, Wo, Wo, Wo, Ww, Ds, Ds, Ww, Ww, Wwr, Wwr, Wo, Wo, Wo
Wwr, Wwr, Wwr, Wwr, Ww, Wwr, Wo, Wo, Wo, Wo, Wo, Wo, Wo, Wo, Wo, Wo, Wo, Wo, Wo, Wo, Wo, Wo, Ww, Ww, Ds, Ww, Ww, Ww, Wwr, Wo, Wo, Wo, Wo
Ww, Ww, Ww, Ww, Ww, Wwr, Wwr, Wo, Wo, Wo, Wo, Wo, Wo, Wo, Wo, Wo, Wo, Wo, Wo, Wo, Wo, Wo, Ww, Ww, Ww, Ww, Ww, Wo, Wo, Wo, Wo, Wo, Wo
Ww, Ww, Ds, Ww, Ds, Ww, Wo, Wo, Wo, Wo, Wo, Wo, Wo, Wo, Wo, Wo, Wo, Wo, Wo, Wo, Wo, Wo, Ww, Ww, Ww, Ww, Ww, Wo, Wo, Wo, Wo, Wo, Wo
Ds, Ds, Ds, Ds, Ww, Ww, Ww, Ww, Ww, Wo, Wo, Wo, Wo, Wo, Ww, Wo, Ww, Wo, Wo, Wo, Wo, Ww, Ww, Ds, Ds, Ds, Ds, Ww, Wo, Wo, Wo, Wo, Wo
Gs^Ftp, Gs^Vht, Ds, Ww, Ww, Ww, Ww, Ww, Ds, Ww, Ww, Ww, Ww, Wo, Ww, Ww^Vm, Ww, Ww, Wo, Wo, Wo, Wo, Ww, Ww^Vm, Ww, Ww, Ww, Ww, Wo, Wo, Wo, Wo, Wo
Gs^Ftp, Gs^Ftp, Gs^Ftp, Ds, Ds, Ds, Ds, Ds, Ds, Ds, Ds, Ww, Ww, Ww, Ww, Ww, Ww, Ww, Ww, Wo, Ww, Wo, Cme, Ww, Cme, Ww, Ww, Wwr, Wo, Wo, Wo, Wo, Wo
Ds, Gs^Ftp, Gs^Ftp, Gs^Ftp, Gs^Ftp, Ds, Gs^Vht, Ds, Ww, Ww, Ww, Ww^Vm, Ww, Ww, Ww, Ww, Ww, Ww, Ww, Ww, Ww, Ww, Ww, 3 Kme, Ww, Ds, Ww, Wwr, Wo, Wo, Wo, Wo, Wo
Ds, Ds, Ww, Gs^Vht, Ds, Gs^Ftp, Ds, Ds, Ww, Wo, Wo, Ww, Wo, Wo, Wo, Wo, Ww, Ww, Ww, Ww, Ds, Ww, Ww, Cme, Ds, Ds, Ww, Wwr, Wwr, Wwr, Wo, Wo, Wo
Ww, Ww, Ww, Ww, Ww, Ds, Ds, Ww, Ww, Wo, Wo, Wo, Wo, Wo, Wo, Wo, Wo, Wo, Ww, Ww, Ds, Ds, Gs^Vht, Ds, Ds, Ww, Ww, Wwr, Ww, Wwr, Wo, Wo, Wo
Ww, Ww, Wo, Ww, Wo, Ww, Ww, Ww, Wo, Wo, Wo, Wo, Wo, Wo, Wwr, Wo, Wo, Wo, Ww, Ww, Ds, Ds, Gs^Ftp, Gs^Ftp, Ds, Ww, Ww, Ww, Ww, Wwr, Wo, Wo, Wo
Wo, Wo, Wo, Wo, Wo, Wo, Wo, Ww, Wo, Wo, Wo, Wo, Wo, Wo, Wwr, Wwr, Ww, Ww, Ww, Ww, Gs^Vht, Gs^Ftp, Gs^Ftp, Gs^Ftp, Ds, Ds, Ww, Ww, Ww, Wwr, Wo, Wo, Wo
Wo, Wo, Wo, Wo, Wo, Wo, Wo, Wo, Wo, Wo, Wo, Wo, Wo, Wo, Wo, Wwr, Ww, Ww, Ds, Ds, Ds, Ds, Ds, Gs^Vht, Ds, Ww, Ww, Ww, Ww, Wo, Wo, Wo, Wo
Wo, Wo, Wo, Wo, Wo, Wo, Wo, Wo, Wo, Wo, Wo, Wo, Wo, Wo, Wo, Wwr, Ww, Ww, Ww, Ds, Ww, Ds, Ww, Ww, Ds, Ww, Ww, Wo, Wo, Wo, Wo, Wo, Wo
Wo, Wo, Wo, Wo, Wo, Wo, Wo, Wo, Wo, Wo, Wo, Wo, Wo, Wwr, Wwr, Ww, Ww, Ww, Ww, Ww, Ww, Ww, Ww, Ww, Ww, Ww, Wo, Wo, Wo, Wo, Wo, Wo, Wo
Wo, Wo, Wo, Wo, Ww, Ww, Ww, Wo, Ww, Wo, Wo, Wo, Wwr, Wwr, Ww, Ww, Ww^Vm, Ds, Ww, Ww, Wwr, Wwr, Wo, Ww, Ww, Ww, Wo, Wo, Wo, Wo, Wo, Wo, Wo
Wo, Wo, Ww, Ww, Ww, Ww, Ww, Ww, Ww, Ww, Ww, Ww, Ww, Ww, Ww, Ww, Ds, Ds, Ww, Ww, Wwr, Wo, Wo, Wo, Wo, Wo, Wo, Wo, Wo, Wwr, Wo, Wo, Wo
Wo, Wo, Ww, Ww, Ds, Ds, Ds, Ds, Ds, Ww, Ww, Ww, Ds, Ww, Ww, Ww, Ww, Ww, Ww, Wo, Wo, Wo, Wo, Wo, Wo, Wo, Wo, Wo, Wwr, Wwr, Wo, Wo, Wo
Wo, Ww, Ww, Ww, Ds, Ce, Ce, Ds, Ds, Ww, Ww, Ww, Ds, Ww^Vm, Ds, Ww, Ww, Ww, Wwr, Wwr, Wo, Wo, Wo, Wo, Wo, Wo, Ww, Wwr, Ww, Wwr, Wwr, Wo, Wo
Wo, Wo, Ww, Ww, Ds, 1 Ke, Ce, Ce, Ce, Ds, Ww, Ww, Ww, Ds, Wwr, Wwr, Wwr, Wo, Wo, Wwr, Wo, Wo, Wo, Wo, Ww, Ww, Ww, Ww, Ww, Ww, Ww, Wo, Wo
Wo, Wo, Ww, Ww, Ds, Ds, Ds, 2 Ke, Ce, Ds, Ds, Ww, Ww, Ds, Wwr, Wwr, Wo, Wo, Wo, Wo, Wo, Wo, Wo, Wo, Ww, Ww, Ds, Ww, Ds, Ds, Ww, Wo, Wo
Wo, Wo, Wo, Ww, Ww, Ds, Ww, Ds, Ds, Ds, Ww, Ww, Wwr, Wwr, Wwr, Wo, Wo, Wo, Wo, Wo, Wo, Wo, Ww, Ww, Ww, Ds, Ds, Gs^Vht, Ds, Ds, Ww, Wo, Wo
Wo, Wo, Wo, Ww, Ww, Ww, Ww, Ww, Ww, Ww, Ww, Ww, Wwr, Wo, Wo, Wo, Wo, Wo, Wo, Wo, Wo, Wo, Ww, Ww, Ww, Ds, Gs^Vht, Gs^Ftp, Ds, Ww, Ww, Ww, Ww
Wo, Wo, Wo, Wo, Wo, Wo, Wo, Ww, Wo, Ww, Wo, Wo, Wo, Wo, Wo, Wo, Wo, Wo, Wo, Wo, Wo, Wo, Wo, Ww, Ww, Ww, Ds, Gs^Ftp, Gs^Ftp, Gs^Vht, Ds, Ww, Ww
Wo, Wo, Wo, Wo, Wo, Wo, Wo, Wo, Wo, Wo, Wo, Wo, Wo, Wo, Wo, Wo, Wo, Wo, Wo, Wo, Wo, Wo, Wo, Ww, Ww, Ww, Ds, Ds, Gs^Ftp, Gs^Ftp, Ds, Ds, Ww
