Wot, Wot, Wot, Wot, Wot, Wot, Wot, Wot, Wot, Wot, Wot, Wot, Wot, Wot, Wot, Wot, Wot, Wot, Wot, Wot, Wot, Wot, Wot, Wot, Wot, Wot, Wot
Wot, Wot, Wot, Wot, Wot, Wot, Wot, Wot, Wot, Wot, Wot, Wot, Wot, Wot, Wot, Wot, Wwrt, Wwt, Wwt, Wwt, Wot, Wot, Wot, Wot, Wot, Wot, Wot
Wot, Wot, Wot, Wot, Wot, Wot, Wot, Wot, Wot, Wot, Wot, Wot, Wot, Wot, Wot, Wot, Ww^Vm, Wwt, Cme, Wwt, Cme, Wot, Wot, Wot, Wot, Wot, Wot
Wot, Wot, Wot, Wot, Wot, Wot, Wot, Wot, Wot, Wot, Wot, Wot, Wot, Wwrt, Wwrt, Wwrt, Wwt, Wwt, Cme, 5 Kme, Cme, Wwrt, Wot, Wot, Wot, Wot, Wot
Wot, Wot, Wot, Wot, Wot, Wot, Wot, Wot, Wot, Wot, Wot, Wot, Wot, Wwrt, Wwt^Wkf, Wwt^Wkf, Wwf, Wwf, Wwt, Wwt, Wwt, Wwrt, Wot, Wot, Wot, Wot, Wot
Wot, Wot, Wot, Wot, Wot, Wot, Wot, Wot, Wot, Wwt, Wwt, Wwt, Wwt, Wwrt, Hd, Ds^Ewsh, Wwt, Wwt, Wwt, Wwt, Wwrt, Wot, Wot, Wot, Wot, Wot, Wot
Wot, Wot, Wot, Wot, Wot, Wot, Wot, Wot, Wwrt, Wwrt, Wwt, Hd, Hd, Ww^Vm, Hd, Wwt, Wwrt, Wwrt, Ww^Vm, Wwf, Wwt, Wwrt, Wot, Wot, Wot, Wot, Wot
Wot, Wot, Wot, Wot, Wwrt, Wot, Wot, Wot, Wot, Wwrt, Wwt, Wwt, Ds, Hd, Wwt, Wwt, Wot, Wwt, Wwrt, Wwf, Wwrt, Wwrt, Wwrt, Wot, Wot, Wot, Wot
Wot, Wot, Wot, Wot, Wwrt, Wwt, Wwt, Wwt, Wwf, Wwf, Wot, Wwf, Wwf, Ds, Wwf, Wot, Wwt^Wkf, Wwt, Ds, Ds, Wwt, Wwrt, Wwt, Wwrt, Wot, Wot, Wot
Wot, Wot, Wwt, Wwrt, Hd, Ds, Wwt, Wwt, Wot, Ww^Vm, Wot, Wwt, Wwf, Wwt^Wkf, Wwt^Wkf, Wwt, Wwt, Wwf, Ds^Ewsh, Gs^Ft, Gs^Ft, Ww^Vm, Ds, Wwrt, Wot, Wot, Wot
Wot, Wwrt, Wwt, Hd, Ds, Ww^Vm, Wwt, Wot, Wot, Wot, Ww, Ww, Wwt, Wwt^Wkf, Wwt, Wwt, Wot, Wwt, Ww^Vm, Ds, Gs^Ft, Gs, Ds, Wwt, Wwrt, Wot, Wot
Wot, Wwt, Wot, Wwt, Wot, Wwt, Wwf, Hd, Wwrt, Ww, Ds, Gs^Ft, Gs^Ft, Gs^Ft, Wwt, Wwt, Wot, Wot, Wwrt, Ds, Wwt, Gs^Ft, Gs^Ft, Wwt, Wwt, Wot, Wot
Wot, Wot, Wot, Wwt, Wot, Wwrt, Wwf, Wwt, Ww, Ww, Cme, Dd, Gs^Ft, Gs^Ft, Wwt, Wot, Ww^Vm, Wot, Wwrt, Wwt, Wwrt, Gs^Ft, Ds, Wwt, Wot, Wot, Wot
Wot, Wot, Wot, Wot, Wot, Wwrt, Ww^Vm, Ww, Ww, Cme, 4 Kme, Cme, Gs^Ft, Gs^Ft, Wwrt, Wot, Wot, Wot, Wot, Wwrt, Wwt^Wkf, Wwf, Wwt, Wwt, Wot, Wot, Wot
Wot, Wot, Wot, Wot, Wot, Wot, Ww, Ww, Ww, Cme, Cme, Ds, Ds, Wwrt, Wwrt, Wot, Wot, Wwrt, Wwrt, Wwrt, Wwt, Wwt^Wkf, Wwt, Wot, Wot, Wot, Wot
Wot, Wot, Wot, Wot, Wot, Wwrt, Ww, Ww, Wwf, Ww, Wwrt, Wwrt, Ww, Wwrt, Ww, Ww, Wwrt, Wwrt, Wwrt, Wwt, Wwf, Wwt, Wwt, Wwrt, Wot, Wot, Wot
Wot, Wot, Wot, Wot, Wwrt, Wwrt, Wwrt, Ww, Wwf, Wwt, Wwt, Ww, Ds, Ww, Wwf, Wwf, Wwt^Wkf, Wwt, Ww^Vm, Wwt, Ds, Wwf, Wwrt, Wwt, Wot, Wot, Wot
Wot, Wot, Wot, Wot, Wwrt, Ww^Vm, Wwt, Ww^Vm, Hd, Ds, Wwf, Ww^Vm, Ds^Ewsh, Ds, Wwrt, Wwt^Wkf, Wwt, Ds, Ds, Gs^Ft, Gs^Ft, Ds, Wwrt, Wwt, Wot, Wot, Wot
Wot, Wot, Wot, Wot, Wwrt, Ds, Wwt, Hd, Hd, Wwf, Wwt, Ww, Wwrt, Wwrt, Wwt, Wwt, Wot, Ww^Vm, Ds, Gs^Ft, Gs^Ft, Ww^Vm, Wwt, Wwrt, Wot, Wot, Wot
Wot, Wot, Wot, Wot, Wot, Wwt, Ds, Hd, Ww^Vm, Ds, Wwt, Wwt, Wwrt, Wot, Wot, Wot, Wot, Wwt, Wwt, Wwf, Wwf, Wwt, Hd, Wot, Wot, Wot, Wot
Wot, Wot, Wot, Wot, Wwrt, Wwt, Wwt^Wkf, Ds, Wwt, Wwt, Wwt, Wwrt, Wot, Wwrt, Wot, Wot, Wot, Wwt, Wot, Wwt, Wwt, Wwt, Wwrt, Wot, Wot, Wot, Wot
Wot, Wot, Wot, Wot, Wot, Wot, Wwt, Wwt^Wkf, Wwrt, Wot, Wot, Wot, Wot, Wot, Wot, Wot, Ww^Vm, Wot, Wot, Wwrt, Wwf, Wwt, Wwrt, Wwt, Wot, Wot, Wot
Wot, Wot, Wot, Wot, Wot, Wwt, Ww^Vm, Wwt, Wwrt, Wot, Wot, Wot, Wot, Wot, Wwrt, Wot, Wot, Wot, Wwrt, Wwt, Wwt, Wwt, Cme, Wwrt, Wot, Wot, Wot
Wot, Wot, Wot, Wot, Wwt, Wwt, Wwt, Ds, Wot, Wot, Wot, Wwt^Wkf, Wwt^Wkf, Ww^Vm, Ds, Wot, Hd, Wwrt, Wwt, Wwt, Wwt, Wwt, Cme, 3 Kme, Wwrt, Wot, Wot
Wot, Wot, Wwt, Wot, Wwt, Wwt, Wwt, Wwt, Ww^Vm, Wot, Wwrt, Wwt^Wkf, Wwt, Ds^Ewsh, Wwf, Wwf, Wwf, Wwt, Ds^Ewsh, Wwf, Wwt, Wwrt, Wwrt, Cme, Wot, Wot, Wot
Wot, Wot, Wwrt, Wwrt, Ds, Wwt, Ds, Wwt, Wwrt, Wwrt, Wwrt, Wwt^Wkf, Wwt, Wwt, Wwt^Wkf, Hd, Hd, Wwt, Ds, Wwf, Wwt, Ww^Vm, Wwrt, Wwrt, Wwrt, Wot, Wot
Wot, Wwt, Wwt, Ds, Ce, Rrd, Ds^Ewsh, Wwt, Wwt, Wwt, Wwrt, Wwt, Ds, Wwt^Wkf, Hd, Hd, Hd, Hd, Ds, Wwt, Wwrt, Wwt, Wot, Wot, Wot, Wot, Wot
Wot, Wwt, Wwt, Rrd, Ce, Rrd, Ce, Ds^Ewsh, Wwt, Wwt, Wwt, Wwt, Ww^Vm, Ds, Hd, Ww^Vm, Wwt, Ds, Wwt, Wwrt, Wot, Wot, Wot, Wot, Wot, Wot, Wot
Wot, Wwt, Wwt, 1 Ke, Wwt, Ce, Rrd, Ds, Wwt, Wwt, Wwrt, Wwt, Ds, Ds, Wwt, Wwt^Wkf, Wwrt, Wwrt, Wwrt, Wwrt, Wot, Wot, Wot, Wot, Wot, Wot, Wot
Wot, Wot, Wwt, Wwt, Wwt, 2 Ke, Wwt, Wwt, Wwt, Wwrt, Wot, Wwt, Wwt, Wwt, Wwrt, Wot, Wot, Wot, Wot, Wot, Wot, Wot, Wot, Wot, Wot, Wot, Wot
Wot, Wot, Wot, Wwt, Wwt, Wwrt, Wwrt, Wwrt, Wwrt, Wot, Wot, Wot, Wot, Wwrt, Wot, Wot, Wot, Wot, Wot, Wot, Wot, Wot, Wot, Wot, Wot, Wot, Wot
Wot, Wot, Wot, Wot, Wot, Wwrt, Wwrt, Wwrt, Wwrt, Wot, Wot, Wot, Wot, Wot, Wot, Wot, Wot, Wot, Wot, Wot, Wot, Wot, Wot, Wot, Wot, Wot, Wot
