Wo, Wo, Wo, Wo, Wo, Wo, Wo, Wo, Wo, Wo, Wo, Wo, Wo, Wo, Wo, Wo, Wo, Wo, Wo, Wo, Wo, Wo, Wo, Wo, Wo, Wo, Wo, Wo, Wo, Wo, Wo, Wo, Wo, Wo, Wo, Wo, Wo, Wo, Wo, Wo, Wo, Wo, Wo, Wo, Wo, Wo, Wo
Wo, Wo, Wo, Wo, Wo, Wo, Wo, Wo, Wo, Wo, Wo, Wo, Wo, Wo, Wo, Wo, Wo, Wo, Wo, Wo, Wo, Wo, Wo, Wo, Wo, Wo, Wo, Wo, Wo, Wo, Wo, Wo, Wo, Wo, Wo, Wo, Wo, Wo, Wo, Wo, Wo, Wo, Wo, Wo, Wo, Wo, Wo
Wo, Wo, Wo, Wo, Wo, Wo, Wo, Wo, Wo, Wo, Wo, Wo, Wo, Wo, Wo, Wo, Wo, Wo, Wo, Wo, Wo, Wo, Wo, Wo, Wo, Wo, Wo, Wo, Wo, Wo, Wo, Wo, Ww, Ww, Ww, Ww, Ww, Wo, Wo, Wo, Wo, Wo, Wo, Wo, Wo, Wo, Wo
Wo, Wo, Wo, Wo, Wo, Wo, Wo, Wo, Wo, Wo, Wo, Wo, Wo, Wo, Wo, Wo, Wo, Wo, Wo, Wo, Wo, Wo, Wo, Wo, Wo, Wo, Wo, Wo, Wo, Wo, Ww, Ww, Ds, Ds, Ds, Ds, Ds, Ww, Ww, Wo, Wo, Wo, Wo, Wo, Wo, Wo, Wo
Wo, Wo, Wo, Wo, Wo, Wo, Wo, Wo, Wo, Wo, Wo, Wo, Wo, Wo, Wo, Wo, Wo, Wo, Wo, Wo, Wo, Wo, Wo, Wo, Wo, Wo, Wo, Wo, Ww, Ww, Ds, Ds, Gs, Gs, Gs, Gs, Gs, Ds, Ds, Ww, Wo, Wo, Wo, Wo, Wo, Wo, Wo
Wo, Wo, Wo, Wo, Wo, Wo, Wo, Wo, Wo, Wo, Wo, Wo, Wo, Wo, Wo, Wo, Wo, Wo, Wo, Wo, Wo, Wo, Gs^Ftp, Wo, Gs^Ftp, Gs^Ftp, Gs^Ftp, Gs^Ftp, Ds, Ds, Gs^Ftp, Gs^Ftp, Gs^Ftp, Gs^Ftp, Gs^Ftp, Gs^Ftp, Gs^Ftp, Gs, Ds, Ww, Ww, Wo, Wo, Wo, Wo, Wo, Wo
Wo, Wo, Wo, Wo, Wo, Wo, Wo, Wo, Wo, Wo, Wo, Wo, Wo, Wo, Wo, Wo, Wo, Wo, Gs^Ftp, Gs^Ftp, Gs^Ftp, Gs^Ftp, Gs, Gs^Ftp, Gs^Ftp, Gs^Ftp, Gs, Gs^Ftp, Rd, Rd, Gs^Ftp, Gs^Ftp, Gs^Ftp, Gs^Ftp, Gs^Ftp, Gs^Ftp, Gs, Gs, Gs, Ds, Ww, Wo, Wo, Wo, Wo, Wo, Wo
Wo, Wo, Wo, Wo, Wo, Wo, Wo, Wo, Wo, Wo, Wo, Wo, Wo, Wo, Wo, Wo, Wo, Gs^Ftp, Gs^Ftp, Gs^Ftp, Gs^Ftp, Gs^Ftp, Gs^Ftp, Gs^Vht, Gs^Ftp, Gs^Ftp, Gs^Ftp, Gs, Gs^Ftp, Gs^Ftp, Gs^Ftp, Gs^Ftp, Gs^Ftp, Gs^Ftp, Gs^Ftp, Gs^Ftp, Gs^Ftp, Gs^Ftp, Gs^Ftp, Ds, Ww, Wo, Wo, Wo, Wo, Wo, Wo
Wo, Wo, Wo, Wo, Wo, Wo, Wo, Wo, Wo, Wo, Wo, Wo, Wo, Wo, Wo, Wo, Gs^Ftp, Gs^Ftp, Gs^Ftp, Gs^Ftp, Gll^Ftr, Gs^Ftp, Gs^Ftp, Gs^Ftp, Gs^Ftp, Gs^Ftp, Gs^Ftp, Gs, Gs^Ftp, Gs^Ftp, Gs^Ftp, Gs^Ftp, Gs^Ftp, Gs^Ftp, Gs^Ftp, Gs^Ftp, Gs^Ftp, Gs^Ftp, Ds, Ds, Ww, Wo, Wo, Wo, Wo, Wo, Wo
Wo, Wo, Wo, Wo, Wo, Wo, Wo, Wo, Wo, Wo, Wo, Wo, Wo, Wo, Wo, Wo, Gs^Ftp, Gs^Ftp, Gs^Ftp, Gll^Ftr, Gll^Ftr, Gs^Ftp, Gll^Ftr, Gs^Ftp, Gs^Ftp, Gs^Ftp, Gs^Ftp, Gs^Ftp, Gs^Ftp, Gs^Ftp, Gs^Vht, Gs^Ftp, Gs^Ftp, Gs^Ftp, Gs^Ftp, Gs^Ftp, Gs^Ftp, Gs^Ftp, Ds, Ww, Ww, Wo, Wwr, Wo, Wo, Wo, Wo
Wo, Wo, Wo, Wo, Wo, Wo, Wo, Wo, Wo, Wo, Wo, Wo, Wo, Wo, Sm, Ww, Ww, Gs^Ftp, Gll^Ftr, Ss, Gs^Ftp, Ww, Ww, Gs^Ftp, Gs^Ftp, Gs^Ftp, Gs^Ftp, Gs^Ftp, Gs^Ftp, Gs^Em, Gs^Ftp, Gs^Ftp, Gs^Ftp, Gs^Ftp, Gs^Ftp, Gs^Ftp, Gs^Ftp, Hh, Hd, Ww, Ww, Ww, Wwr, Wo, Wo, Wo, Wo
Wo, Wo, Wo, Wo, Wo, Wo, Wo, Wo, Wo, Wo, Wo, Wo, Wo, Sm, Gs^Ftp, Gs^Ftp, Gll^Ftr, Gll^Ftr, Ss, Gs^Ftp, Gll^Ftr, Gs^Ftp, Ss, Gs^Ftp, Gll^Ftr, Ss, Ss, Hh^Ftp, Hh^Ftp, Gs^Ftp, Mm, Hh^Ft, Hh, Hh^Ft, Gs^Ftp, Gs^Ftp, Gs^Ftp, Hh, Hh^Ftp, Hd, Ww, Wwr, Wo, Wo, Wo, Wo, Wo
Wo, Wo, Wo, Wo, Wo, Wo, Wo, Wo, Wo, Wo, Wo, Wo, Sm, Sm, Ss, Gs^Ftp, Gs^Ftp, Ss, Gll^Ftr, Gll^Ftr, Ww, Ss, Gll^Ftr, Gs^Ftp, Gs^Ftp, Gs^Ftp, Gs^Ftp, Gs^Ftp, Hh^Ftp, Hh^Ftp, Mm, Mm, Mm, Gs^Ftp, Gs^Ftp, Hh, Hh, Hh^Ftp, Hd, Hd, Ww, Wwr, Wo, Wo, Wo, Wo, Wo
Wo, Wo, Wo, Wo, Wo, Wo, Wo, Wo, Wo, Wo, Wo, Wo, Sm, Gs^Ftp, Gs^Ftp, Ww, Gll^Ftr, Gll^Ftr, Gll^Ftr, Ss^Vhs, Gll^Ftr, Gll^Ftr, Gll^Ftr, Gll^Ftr, Gs^Ftp, Ww, Ww, Ss, Ss, Hh^Ftp, Hh, Mm, Hh^Ftp, Hh^Ftp, Hh^Ftp, Hh, Mm, Hh^Ftp, Hd, Ww, Ww, Wo, Wo, Wo, Wo, Wo, Wo
Wo, Wo, Wo, Wo, Wo, Wo, Wo, Wo, Wo, Wo, Wo, Wo, Ww, Ss, Ss, Gs^Ftp, Ss, Ss, Gs^Ftp, Gs^Ftp, Ss, Ww, Gll^Ftr, Ss, Hh, Ss, Hh^Ftp, Ss, Hh, Hh^Ftp, Hh, Hh^Vc, Mm, Hh^Ftp, Mm, Mm, Hd, Hd, Ww, Ww, Wo, Wo, Wo, Wo, Wo, Wo, Wo
Wo, Wo, Wo, Wo, Wo, Wo, Wo, Wo, Wo, Wo, Sm, Sm, Gs^Ftp, Ww, Ww, Gs^Ftp, Ww, Ww, Ww, Ww, Gs^Ftp, Gll^Ftr, Ss, Ss, Hh^Ftp, Ss, Mm, Hh^Ftp, Hhd, Hhd, Mm, Mm, Mm, Mm, Mm, Mm, Hd, Ww, Ww, Wwr, Wo, Wo, Wo, Wo, Wo, Wo, Wo
Wo, Wo, Wo, Wo, Wo, Wo, Wo, Wo, Wo, Sm, Gs^Ft, Sm, Ss, Ss, Gs^Ftp, Ww, Wo, Wo, Wo, Ww, Hh, Hh, Hh, Hh, Hh^Ftp, Hh, Mm, Mm, Hh^Ftp, Hhd, Hhd, Hd, Hd, Hd, Hd, Hd, Ww, Ww, Wwr, Wwr, Wo, Wo, Wo, Wo, Wo, Wo, Wo
Wo, Wo, Wo, Wo, Wo, Wo, Wo, Wo, Sm, Sm, Ss, Gll^Ftr, Gll^Ftr, Gs^Ftp, Ww, Ww, Wo, Wo, Ww, Ww, Hh, Hh^Ftp, Hh^Ftp, Hh^Ftp, Mm, Hh, Hh^Ftp, Hh, Hh, Hh, Hd, Hd, Ww, Hd, Hd, Hd, Hd, Ww, Ww, Wwr, Wwr, Wo, Wo, Wo, Wo, Wo, Wo
Wo, Wo, Wo, Wo, Wo, Wo, Wo, Sm, Gs^Ftp, Gs^Ftp, Gll^Ftr, Gll^Ftr, Ss, Ss, Gs^Ftp, Ww, Ww, Ww, Ww^Es, Mm, Hh, Hh, Mm, Mm, Mm, Hh, Hh^Ftp, Hh^Ftp, Mm, Hd, Hd, Ww, Ww^Vm, Ww, Ww, Ww, Ww, Ww, Ww, Ww, Wwr, Wo, Wo, Wo, Wo, Wo, Wo
Wo, Wo, Wo, Wo, Wo, Wo, Ds, Sm, Gs^Ftp, Ss, Ss, Gll^Ftr, Ss^Vhs, Gll^Ftr, Ss, Ww, Hh, Mm, Mm, Mm, Mm, Hh^Vc, Mm, Mm, Hh^Ftp, Hh, Mm, Hh^Ftp, Mm, Hh^Ftp, Hd, Ww, Ww, Ww, Ww, Ww, Ww, Ww, Hd, Ww, Wo, Wo, Wo, Wo, Wo, Wo, Wo
Wo, Wo, Wo, Wo, Wo, Wo, Ww, Ds, Gs^Ftp, Gs^Ftp, Gll^Ftr, Gs^Ftp, Gll^Ftr, Gll^Ftr, Gg^Ftp, Gs^Ftp, Gs^Ftp, Hh^Ft, Hhd, Hhd, Mm, Mm, Mm, Mm, Mm, Hh^Ftp, Hh, Mm, Mm, Hh^Ftp, Hhd, Hd, Ww, Hd, Hd, Ww, Ww, Hd, Hd, Ww, Ww, Wwr, Wo, Wo, Wo, Wo, Wo
Wo, Wo, Wo, Wo, Wo, Dd^Ftd, Ww, Ds, Ss, Ss, Gll^Ftr, Gs^Ftp, Ss, Ss, Gll^Ftr, Gs^Ftp, Gs^Ftp, Hhd, Hh^Ftp, Hh^Ftp, Hh^Ftp, Mm, Hd, Mm, Hh^Ftp, Hh^Ftp, Hh^Ftp, Mm, Mm, Md, Hhd, Hd, Hd, Hd, Hd, Ww, Ww, Ww^Vm, Hd, Ww, Wo, Wwr, Wo, Wo, Wo, Wo, Wo
Wo, Wo, Wo, Wo, Ds, Dd^Ftd, Dd^Ftd, Ww, Ds, Ss, Gs^Ftp, Gs^Ftp, Gs^Ftp, Gs^Ftp, Gs^Em, Gs^Ftp, Gs^Ftp, Gs^Ftp, Hh^Ftp, Hh^Ftp, Hh^Ftp, Hh^Ftp, Hd, Ww, Hh^Ftp, Hh^Ftp, Hh^Vc, Mm, Mm, Mm, Hh^Ftp, Hhd, Mm, Mm, Hd, Hd, Ww, Ww, Ww, Ww, Wo, Wo, Wo, Wo, Wo, Wo, Wo
Wo, Wo, Wo, Wo, Ds, Dd^Ftd, Ww, Ww, Ds, Gs^Ftp, Gs^Ftp, Gs^Ftp, Gs, Gs, Gs, Gs^Ftp, Gs^Ftp, Gs^Ftp, Gs^Ftp, Hh^Ftp, Ss, Ss, Ww, Ww, Hh^Ftp, Hh^Ftp, Hh^Ftp, Hh, Hh^Ftp, Mm, Mm, Mm, Mm, Mm, Hd, Hd, Ww, Wwr, Wwr, Wwr, Wo, Wo, Wo, Wo, Wo, Wo, Wo
Wo, Wo, Wo, Wo, Wo, Ds, Ww, Ds, Gs^Ftp, Gs^Ftp, Gs^Ftp, Gs^Ftp, Ds, Ds, Ds, Gs^Ftp, Gs, Gs^Vht, Gs^Ftp, Gs^Ftp, Ss, Ww, Ss, Ss, Ss, Hh^Ftp, Ss, Hh, Mm, Mm, Mm, Mm, Mm, Mm, Hd, Ww, Wwr, Wwr, Wo, Wo, Wo, Wo, Wo, Wo, Wo, Wo, Wo
Wo, Wo, Wo, Wo, Wo, Wo, Ds, Ds, Gs^Ftp, Gs^Ftp, Ds, Ds, Ww, Ww, Ww, Ds, Gs, Rd, Rd, Ss, Ww, Ww, Gs^Ftp, Gs^Ftp, Gs^Ftp, Ss, Hh^Ftp, Hh^Ftp, Mm, Mm, Mm, Mm, Hd, Hd, Ww, Ww, Wwr, Wo, Wo, Wo, Wo, Wo, Wo, Wo, Wo, Wo, Wo
Wo, Wo, Wo, Wo, Wo, Wo, Ds, Gs^Ftp, Gs^Vht, Gs, Ds, Ww, Ww, Ww, Ww, Ds, Gs, Gs^Ftp, Ss, Wwf, Ss, Gs^Ftp, Gs^Ftp, Gs^Ftp, Gs^Ftp, Ss, Ss, Ss, Ww, Mm, Mm, Mm, Hd, Hd, Ww, Wwr, Wwr, Wo, Wo, Wo, Wo, Wo, Wo, Wo, Wo, Wo, Wo
Wo, Wo, Wo, Wo, Wo, Wo, Ds, Gs^Ftp, Gs^Ftp, Ds, Ww, Ww, Ww, Ww, Ds, Ds, Gs^Ftp, Gs^Ftp, Ww, Ww, Gs^Ftp, Gs^Ftp, Gs^Ftp, Gs^Vht, Gs^Ftp, Ss, Ww, Ww, Ss, Mm, Mm, Hd, Hd, Ww, Ww, Ww, Wo, Wo, Wo, Wo, Wo, Wo, Wo, Wo, Wo, Wo, Wo
Wo, Wo, Wo, Wo, Wo, Wo, Ww, Ds, Gs^Ftp, Ds, Ww, Ww, Ww, Ww, Ds, Gs^Ftp, Gs^Ftp, Gs^Ftp, Gs^Ftp, Ww, Ss, Gs^Ftp, Gs^Ftp, Gs^Ftp, Gs^Ftp, Gs^Ftp, Ww, Ss, Hhd, Hhd, Hhd, Hhd, Hd, Ww, Ww, Wwr, Wo, Wo, Wo, Wo, Wo, Wo, Wo, Wo, Wo, Wo, Wo
Wo, Wo, Wo, Wo, Wo, Wo, Ww, Ds, Ds^Ewsh, Ds, Wwf, Ww, Ww, Ww, Ww, Ds, Ds, Gs^Ftp, Ss, Ww, Ww, Ss, Gs^Ftp, Gs^Ftp, Gs^Ftp, Wwf, Ss, Ss, Hh^Ftp, Hh^Ftp, Mm, Hd, Ww, Ww, Wwr, Wwr, Wwr, Wo, Wo, Wo, Wo, Wo, Wo, Wo, Wo, Wo, Wo
Wo, Wo, Wo, Wo, Wo, Wo, Wo, Ww, Ww, Ds, Wwf, Ww, Ww, Ww, Ww, Ds, Ww^Vm, Ds, Ds, Ww, Ds, Ss, Gs^Ftp, Ss, Ww, Ww, Ss, Gs^Ftp, Hh^Ftp, Hh, Mm, Hd, Hd, Ww, Ww, Wwr, Wo, Wo, Wo, Wo, Wo, Wo, Wo, Wo, Wo, Wo, Wo
Wo, Wo, Wo, Wo, Wo, Wo, Wo, Wo, Wo, Ww, Ds, Ds, Ww, Ww, Ww, Ww, Ww, Ds, Ww, Ww, Ds, Gs^Ftp, Gs^Ftp, Ss, Ww, Ss, Gs^Ftp, Gs^Ftp, Gs^Ftp, Hh^Ftp, Hh^Ftp, Hh^Ftp, Hd, Ww, Wwr, Wwr, Wo, Wo, Wo, Wo, Wo, Wo, Wo, Wo, Wo, Wo, Wo
Wo, Wo, Wo, Wo, Wo, Wo, Wo, Wo, Wo, Ww, Ww, Ds^Ewsh, Ww, Ww, Ww, Ww, Ww, Ww, Ww, Ww, Ds, Ds, Ds, Ss, Ww, Ss, Gs^Ftp, Gs^Vht, Gs^Ftp, Hh^Ftp, Hh^Ftp, Hd, Ww, Ww, Wo, Wwr, Wo, Wo, Wo, Wo, Wo, Wo, Wo, Wo, Wo, Wo, Wo
Wo, Wo, Wo, Wo, Wo, Wo, Wo, Wo, Wo, Wo, Ww, Ds^Ewsh, Ds, Wwf, Ds, Ww, Ww, Ww, Ww, Ww, Ww, Ww, Ww, Ww, Ww, Ds, Ds, Ds, Ds, Hh^Ftp, Hd, Hd, Ww, Ww, Wwr, Wo, Wo, Wo, Wo, Wo, Wo, Wo, Wo, Wo, Wo, Wo, Wo
Wo, Wo, Wo, Wo, Wo, Wo, Wo, Wo, Wo, Wo, Wo, Ww, Ww, Ww, Ww, Ds^Ewsh, Ds^Ewsh, Wwf, Ds, Ds, Ww, Ww, Ww, Ww, Ww, Ww, Ww, Ww, Ds, Hd, Ww, Ww, Ww, Wwr, Wo, Wo, Wo, Wo, Wo, Wo, Wo, Wo, Wo, Wo, Wo, Wo, Wo
Wo, Wo, Wo, Wo, Wo, Wo, Wo, Wo, Wo, Wo, Wo, Wo, Wo, Ww, Wo, Ww, Ww, Ww, Ww, Ds^Ewsh, Ww, Ww, Wwr, Ww, Ww, Ww, Wwr, Ww, Ww, Ww, Ww, Wwr, Wo, Wwr, Wo, Wo, Wo, Wo, Wo, Wo, Wo, Wo, Wo, Wo, Wo, Wo, Wo
Wo, Wo, Wo, Wo, Wo, Wo, Wo, Wo, Wo, Wo, Wo, Wo, Wo, Wo, Wo, Wo, Wo, Wo, Wo, Ww, Wo, Wwr, Wo, Wwr, Wo, Wwr, Wwr, Wwr, Wwr, Wwr, Wo, Wo, Wo, Wo, Wo, Wo, Wo, Wo, Wo, Wo, Wo, Wo, Wo, Wo, Wo, Wo, Wo
Wo, Wo, Wo, Wo, Wo, Wo, Wo, Wo, Wo, Wo, Wo, Wo, Wo, Wo, Wo, Wo, Wo, Wo, Wo, Wo, Wo, Wo, Wo, Wo, Wo, Wo, Wo, Wo, Wo, Wo, Wo, Wo, Wo, Wo, Wo, Wo, Wo, Wo, Wo, Wo, Wo, Wo, Wo, Wo, Wo, Wo, Wo
Wo, Wo, Wo, Wo, Wo, Wo, Wo, Wo, Wo, Wo, Wo, Wo, Wo, Wo, Wo, Wo, Wo, Wo, Wo, Wo, Wo, Wo, Wo, Wo, Wo, Wo, Wo, Wo, Wo, Wo, Wo, Wo, Wo, Wo, Wo, Wo, Wo, Wo, Wo, Wo, Wo, Wo, Wo, Wo, Wo, Wo, Wo
