Wot, Wot, Wot, Wot, Wot, Wot, Wot, Wot, Wot, Wot, Wot, Wot, Wot, Wot, Wot, Wot, Wot, Wot, Wot, Wot, Wot, Wot, Wot, Wot, Wot, Wot, Wot, Wot, Wot, Wot, Wot, Wot, Wot, Wot, Wot, Wot, Wot, Wot, Wot, Wot, Wot, Wot, Wot, Wot, Wot, Wot, Wot, Wot, Wot
Wot, Wot, Wot, Wot, Wot, Wot, Wot, Wot, Wot, Wot, Wot, Wot, Wot, Wot, Wot, Wot, Wot, Wot, Wot, Wot, Wot, Wot, Wot, Wot, Wot, Wot, Wot, Wot, Wot, Wot, Wot, Wot, Wot, Wot, Wot, Wot, Wwt, Wot, Wwt, Wot, Wot, Wot, Wot, Wot, Wot, Wot, Wot, Wot, Wot
Wot, Wot, Wot, Wot, Wot, Wot, Wot, Wot, Wot, Wot, Wot, Wot, Wot, Wot, Wot, Wot, Wot, Wot, Wot, Wot, Wot, Wot, Wot, Wot, Wot, Wot, Wot, Wot, Wwt, Wot, Wwt, Wwt, Wwt, Wwt, Wwt, Wwt, Wwt, Wwt, Wwt, Wwt, Wwt, Wot, Wot, Wot, Wot, Wot, Wot, Wot, Wot
Wot, Wot, Wot, Wot, Wot, Wot, Wot, Wot, Wot, Wot, Wot, Wot, Wot, Wot, Wot, Wot, Wot, Wot, Wot, Wot, Wot, Wot, Wwt, Wot, Wwt, Wwt, Wwt, Wwt, Wwt, Wwt, Wwt, Wwt, Wwt, Wwt, Wwt, Wwt, Wwt, Wwt, Wwt, Wwt, Wwt, Wwt, Wwt, Wot, Wot, Wot, Wot, Wot, Wot
Wot, Wot, Wot, Wot, Wot, Wot, Wot, Wot, Wot, Wot, Wot, Wot, Wot, Wot, Wot, Wot, Wot, Wot, Wot, Wot, Wwt, Wwt, Wwt, Wwt, Wwt, Wwt, Wwt, Wwt, Wwt, Wwt, Wwt, Wwt, Ds^Ewsh, Wwt, Ds, Wwt, Ds, Wwt, Ds^Ewsh, Wwt, Wwt, Wwt, Wwt, Wot, Wot, Wot, Wot, Wot, Wot
Wot, Wot, Wot, Wot, Wot, Wot, Wot, Wot, Wot, Wot, Wot, Wot, Wot, Wot, Wot, Wot, Wwt, Wot, Wwt, Wwt, Wwt, Wwt, Wwt, Wwt, Ds^Ewsh, Wwt, Ds, Ds, Ds, Wwt, Ds^Ewsh, Ds^Ewsh, Ds, Ds, Ds^Ewsh, Ds, Ds, Ds, Ds, Ds^Ewsh, Ds^Ewsh, Wwt, Wwt, Wwt, Wwt, Wot, Wot, Wot, Wot
Wot, Wot, Wot, Wot, Wot, Wot, Wot, Wot, Wot, Wot, Wot, Wot, Wot, Wot, Wot, Wot, Wwt, Wwt, Wwt, Wwt, Ds, Ds, Ds, Ds^Ewsh, Ds, Ds, Ds, Ds, Gs^Ft, Ds, Dd, Ds, Gs^Ft, Dd, Gs, Gs, Gs^Ft, Gd, Gd, Ds, Ds^Ewsh, Wwt, Wwt, Wwt, Wwt, Wot, Wot, Wot, Wot
Wot, Wot, Wot, Wot, Wot, Wot, Wot, Wot, Wot, Wot, Wot, Wot, Wot, Wot, Wwt, Wwt, Wwt, Wwt, Wwt, Ds^Ewsh, Ds, Ds, Ds, Ds, Gs^Ft, Gs^Ft, Gs^Ft, Gs^Ft, Gs^Vht, Gs^Ft, Gs^Ft, Gs^Ft, Gs^Ft, Gs^Ft, Gs^Ft, Gs^Ft, Gs^Ft, Gs^Ft, Gd, Gd, Dd, Ds, Wwt, Wwt, Wwt, Wot, Wot, Wot, Wwt
Wot, Wot, Wot, Wot, Wot, Wot, Wot, Wot, Wot, Wot, Wot, Wot, Wot, Wot, Wwt, Wwt, Wwt, Wwt, Ds, Ds, Gs^Ft, Gs^Ft, Gs^Ft, Gs^Ft, Gs^Ft, Gs^Ft, Gs^Ft, Gs^Ft, Gs^Ft, Gs^Ft, Gs^Ft, Gs^Ft, Gs^Ft, Gs^Ft, Gs^Ft, Gs^Ft, Gs^Ft, Gs^Ft, Gs^Ft, Gd, Ds^Ewsh, Ds, Wwt, Wwt, Wwt, Wwrt, Ds, Wot, Wwt
Wot, Wot, Wot, Wot, Wot, Wot, Wot, Wot, Wot, Wot, Wot, Wot, Wot, Wot, Wwt, Wwt, Wwt, Wwt, Ds, Gs^Ft, Gs^Ft, Gs^Ft, Gs^Ft, Gs^Ft, Gs^Ft, Gs^Ft, Gs^Ft, Gs^Ft, Gll^Ftr, Gs^Ft, Gs^Ft, Gs^Ft, Gs^Ft, Gs^Ft, Gs^Ft, Gs^Ft, Gs^Ft, Gs^Ft, Gs^Ft, Ds, Ds^Ewsh, Wwt, Wwt, Wwt, Wwrt, Wwrt, Ds, Ds, Ds
Wot, Wot, Wot, Wot, Wot, Wot, Wot, Wot, Wot, Wot, Wot, Wot, Wwt, Wwt, Wwt, Wwt, Ds, Ds, Gs^Ft, Gs^Ft, Gs^Ft, Gs^Ft, Gll^Ftr, Gll^Ftr, Gs^Ft, Gll^Ftr, Gll^Ftr, Gll^Ftr, Gll^Ftr, Gs^Ft, Gs^Ft, Gs^Ft, Gs^Ft, Gs^Ft, Gs^Ft, Gs^Ft, Gs^Ft, Gs^Ft, Gd, Ds, Ds^Ewsh, Wwt, Wwt, Wwt, Wwrt, Ds, Wot, Ds, Wot
Wot, Wot, Wot, Wot, Wot, Wot, Wot, Wot, Wot, Wot, Wot, Wot, Wwt, Wwt, Wwt, Ds, Ds, Ds, Gs^Ft, Gs^Ft, Gs^Vht, Gs^Ft, Gs^Ft, Gs^Ft, Gs^Ft, Gs^Ft, Gll^Ftr, Gll^Ftr, Gll^Ftr, Gll^Ftr, Hh^Ft, Gs^Ft, Gs^Ft, Gs^Ft, Gs^Ft, Gs^Ft, Gs^Ft, Gs^Ft, Gd, Gd, Ds, Ds, Wwt, Wwt, Wwt, Wwrt, Wot, Wot, Wot
Wot, Wot, Wot, Wot, Wot, Wot, Wot, Wot, Wot, Wot, Wot, Wwt, Wwt, Wwt, Ds, Ss, Ds, Gs, Gs^Ft, Gs^Ft, Gs^Ft, Gs^Ft, Gs^Ft, Hh, Hh^Ft, Hh^Ft, Hh^Ft, Wwt, Wwt, Hh^Ft, Gs^Ft, Gs^Ft, Hh^Ft, Hh^Ft, Gs^Ft, Gs^Vht, Gs, Gs^Ft, Gd, Gd, Ds, Ds^Ewsh, Wwt, Wwt, Wwt, Wot, Wot, Wot, Ds
Wot, Wot, Wot, Wot, Wot, Wot, Wot, Wot, Wot, Wot, Wwt, Wwt, Wwt, Wwt, Ss, Ds, Gs, Gs^Efm, Ss, Gs^Ft, Gs^Ft, Gs^Ft, Hh^Ft, Hh^Ft, Hh^Ft, Hh^Ft, Hh^Ft, Wwrt, Hh^Ft, Wwt, Hh, Hh, Hh^Ft, Hh^Ft, Gs^Ft, Gs, Gd, Gd, Dd, Dd, Ds, Wwt, Wwt, Wwt, Wot, Wot, Wot, Ds, Wwrt
Wot, Wot, Wot, Wot, Wot, Wot, Wot, Wot, Wot, Wwt, Wwt, Wwt, Wwt, Ss, Ss, Ds, Gll^Ftr, Ss, Gll^Ftr, Gs^Ft, Gs^Ft, Hh, Hh, Hh^Ft, Hh^Ft, Hh^Ft, Hhd, Hhd^Ft, Hh^Ft, Hh^Ft, Hh^Ft, Hh^Ft, Hh^Ft, Hh^Ft, Gs, Gs, Ds, Gd, Ds, Ds^Ewsh, Wwt, Wwt, Wwrt, Wwrt, Wot, Wot, Wot, Wot, Wot
Wot, Wot, Wot, Wot, Wot, Wot, Wot, Wot, Wwt, Wwt, Wwt, Wwt, Ss, Wwt, Wwt, Ss, Gll^Ftr, Gll^Ftr, Wwt, Wwt, Hh^Ft, Hh^Ft, Hh^Ft, Hh^Ft, Hh, Hhd, Hhd, Hhd^Ft, Hh^Ft, Hh^Ft, Hh^Ft, Hh^Ft, Hh^Ft, Hh^Ft, Gd, Ds^Ewsh, Ds^Ewsh, Ds^Ewsh, Wwt, Wwt, Wwt, Wwt, Wwrt, Wot, Wot, Wot, Wot, Wot, Wot
Wot, Wot, Wot, Wot, Wot, Wot, Wot, Wot, Wwt, Wwt, Wwt, Ss, Ds, Ss, Ss, Wwt, Wwt, Gll^Ftr, Wwt, Wwt, Hh^Ft, Hh^Ft, Hh^Ft, Hh, Hhd^Ft, Hhd^Vc, Hhd, Hhd^Ft, Hhd^Ft, Hh, Hh, Hh^Ft, Hh^Ft, Gd, Dd, Ds^Ewsh, Wwrt, Wwrt, Wwt, Wwrt, Wot, Wot, Wot, Wot, Wot, Wot, Wot, Wot, Wot
Wot, Wot, Wot, Wot, Wot, Wot, Wwt, Wwt, Wwt, Wwt, Ds, Ds, Ss, Ds, Gll^Ftr, Gll^Ftr, Gll^Ftr, Wwt, Wwt, Wwt, Wwt, Hh^Ft, Hh^Ft, Hh, Hh^Ft, Hhd, Hhd, Hhd^Ft, Mm, Hh, Hh, Hh, Hh^Ft, Dd, Wwt, Ds^Ewsh, Wwt, Wwt, Wwrt, Wwrt, Wot, Wot, Wot, Wot, Wot, Wot, Wot, Wot, Wot
Wot, Wot, Wot, Wot, Wot, Wwt, Wwt, Wwt, Wwt, Ds, Ds, Ds, Gs, Gs, Gll^Ftr, Gll^Ftr, Ss, Wwt, Hh^Ft, Hh, Gs^Ft, Hh, Hh^Ft, Hh^Ft, Hh^Ft, Hhd^Ft, Hhd, Hhd, Mm, Hh, Hh, Hh^Ft, Hh^Ft, Wwrt, Wwt, Wwt, Wwt, Wwt, Wwt, Wwt, Wot, Wot, Wot, Wot, Wot, Wot, Wot, Wot, Wot
Wot, Wot, Wot, Wot, Wot, Wwt, Wwt, Wwt, Ds, Ds, Ds, Gs, Gs^Ft, Gs^Ft, Gll^Ftr, Ss, Gll^Ftr, Gs^Ft, Gll^Ftr, Gs^Ft, Gs^Ft, Gs^Ft, Hh^Ft, Hhd, Hhd, Hhd, Hhd, Mm, Mm, Mm, Hhd^Ft, Hh, Hh^Ft, Wwt, Wwt, Wwrt, Wwrt, Wwrt, Wwt, Ww^Vm, Wwrt, Wot, Wot, Wot, Wot, Wot, Wot, Wot, Wot
Wot, Wot, Wot, Wot, Wwt, Wwt, Wwt, Wwt, Ds, Ds, Gs^Ft, Gs^Ft, Gs^Ft, Gs^Ft, Gll^Ftr, Gs^Ft, Ss, Gs^Ft, Gs^Ft, Gs^Ft, Gs^Ft, Hh^Ft, Gs^Ft, Hh, Hh^Ft, Hhd^Ft, Mm, Mm, Mm, Mm, Mm, Hhd^Ft, Hhd, Hhd^Ft, Wwrt, Mm, Hhd, Wwt, Wwt, Wwt, Wwt, Wot, Wot, Wot, Wot, Wot, Wot, Wot, Wot
Wot, Wot, Wot, Wot, Wwt, Wwt, Wwt, Ds, Ds, Gs^Ft, Gs^Ft, Gs^Ft, Gs^Ft, Gll^Ftr, Gs^Efm, Ss, Gll^Ftr, Gll^Ftr, Gs^Ft, Gs^Vht, Gs^Ft, Gs^Ft, Hh^Ft, Hh, Hh^Ft, Hh^Ft, Hh, Hh, Mm, Hhd^Ft, Hhd^Ft, Hhd^Vc, Hhd^Ft, Hhd^Ft, Mm, Mm, Mm, Wwrt, Wwt, Wwt, Wwt, Wwt, Wot, Wot, Wot, Wot, Wot, Wot, Wot
Wot, Wot, Wot, Wot, Wwt, Wwt, Ds, Ds, Gs^Ft, Gs^Ft, Gs^Ft, Gs^Ft, Gs^Ft, Ss, Gs^Es, Gs, Gs^Ft, Gll^Ftr, Gs^Ft, Gs^Ft, Gs^Ft, Gs^Ft, Hh^Ft, Hh, Hh^Ft, Hh^Ft, Hh^Ft, Hh^Ft, Hh, Hhd^Ft, Hh^Ft, Hhd, Hhd, Hhd^Ft, Mm, Mm, Mm, Hhd, Wwt, Wwt, Wwt, Wwrt, Wot, Wot, Wot, Wot, Wot, Wot, Wot
Wot, Wot, Wot, Wot, Wwt, Wwt, Ds, Ds, Gs^Ft, Gs^Ft, Gs^Ft, Gs^Vht, Gs, Gs, Ds, Gs, Ds, Gs^Ft, Gs, Gs^Ft, Gs^Ft, Gs^Ft, Gs^Ft, Hh^Ft, Hh, Hh, Gs^Ft, Hh^Ft, Hh^Ft, Hh^Ft, Hh^Ft, Hh^Ft, Mm, Hhd, Hhd, Hhd, Hhd, Hhd, Wwt, Wwt, Wwrt, Wwrt, Wot, Wot, Wot, Wot, Wot, Wot, Wot
Wot, Wot, Wot, Wot, Wwt, Wwt, Wwt, Ds, Ds, Gs^Ft, Gs^Ft, Gs^Ft, Dd^Esd, Dd^Esd, Ds, Ds, Ds, Dd, Gs, Gs^Ft, Gs^Ft, Gs^Ft, Gs^Ft, Gs^Ft, Gs^Ft, Gs^Ft, Gs^Ft, Hh^Ft, Hh^Ft, Hh^Ft, Hh^Ft, Hh^Ft, Mm, Mm, Hh^Ft, Hhd, Hhd, Wwrt, Wwt, Wwt, Wwrt, Wwt, Wot, Wot, Wot, Wot, Wot, Wot, Wot
Wot, Wot, Wot, Wot, Wwt, Wwt, Wwt, Ds, Ds, Gs^Ft, Gs^Ft, Gs^Ft, Ds, Ds, Wwt, Wwt, Wwt, Ds^Esd, Ds, Gs, Gs^Ft, Gs^Ft, Gs^Ft, Gs^Ft, Gs^Ft, Gs^Ft, Hh, Gs^Ft, Hh, Hh, Hh^Ft, Hh^Ft, Mm, Mm, Hh^Ft, Hhd, Wwt, Wwrt, Wwt, Wwt, Wot, Wot, Wot, Wot, Wot, Wot, Wot, Wot, Wot
Wot, Wot, Wot, Wot, Wot, Wwt, Wwt, Wwt, Ds, Gs^Ft, Gs^Ft, Ds^Esd, Ds, Wwt, Wwt, Wwt, Wwt, Ds^Esd, Ds^Esd, Gs, Gs^Ft, Gs^Ft, Gs^Ft, Gs^Ft, Hh^Ft, Gs^Ft, Hh, Gs^Ft, Hh^Ft, Hh^Ft, Hh^Ft, Mm, Hh, Hh^Ft, Hh, Hhd, Wwt, Wwt, Wwrt, Wwt, Wot, Wot, Wot, Wot, Wot, Wot, Wot, Wot, Wot
Wot, Wot, Wot, Wot, Wot, Wwt, Wwt, Wwt, Ds, Ds, Ds, Ds, Wwrt, Wwrt, Wwt, Wwt, Wwrt, Ds, Gs^Ft, Gs^Ft, Gs^Ft, Gs^Ft, Gs^Vht, Gs^Ft, Gs^Ft, Gs^Ft, Gs^Ft, Hh^Ft, Hh^Ft, Hh^Ft, Hh^Ft, Hh^Ft, Hh, Hh, Hh^Ft, Wwt, Wwt, Wwrt, Wwrt, Wot, Wot, Wot, Wot, Wot, Wot, Wot, Wot, Wot, Wot
Wot, Wot, Wot, Wot, Wot, Wwt, Wwt, Wwt, Wwt, Ds, Ds, Ds, Wwt, Wwt, Wwt, Wwt, Wwrt, Ds, Ds, Gs^Ft, Gs^Ft, Gs^Ft, Gs^Ft, Gs^Ft, Gs^Ft, Gs^Ft, Hh^Ft, Hh^Ft, Hh^Ft, Hh^Ft, Hh^Ft, Hh, Hh^Vc, Hh, Hh^Ft, Wwt, Wwt, Wwrt, Wot, Wot, Wot, Wot, Wot, Wot, Wot, Wot, Wot, Wot, Wot
Wot, Wot, Wot, Wot, Wot, Wot, Wwt, Wwt, Wwt, Ds, Wwt, Ds, Wwt, Wwrt, Wot, Wwt, Wwt, Ds, Ds, Gs^Ft, Gs, Gs, Gs, Gs^Efm, Gs^Ft, Gs^Ft, Gs^Ft, Hh^Ft, Hh, Hh^Ft, Hh^Ft, Hh^Ft, Hh, Hh, Wwt, Wwt, Wwt, Wwt, Wot, Wot, Wot, Wot, Wot, Wot, Wot, Wot, Wot, Wot, Wot
Wot, Wot, Wot, Wot, Wot, Wot, Wot, Wwt, Wwt, Wwt, Wwt, Wwt, Wwrt, Wwrt, Wot, Wwt, Wwt, Ds, Wwt, Ds, Ds, Ds, Ds^Esd, Gs^Ft, Gs^Ft, Gs^Ft, Gs^Ft, Hh, Hh^Ft, Hh^Ft, Gd, Hh^Ft, Hh^Ft, Hh^Ft, Hh^Ft, Wwt, Wwt, Wwrt, Wwrt, Wot, Wot, Wot, Wot, Wot, Wot, Wot, Wot, Wot, Wot
Wot, Wot, Wot, Wot, Wot, Wot, Wot, Wot, Wwt, Wwt, Wwt, Ww^Vm, Wwt, Wot, Wot, Wwrt, Wwt, Wwt, Wwt, Ds, Wwt, Wwt, Ds, Ds^Esd, Gs, Gs, Ds, Gs^Ft, Gd, Hh^Ft, Gd^Es, Gd^Es, Dd, Hh, Hh^Ft, Wwrt, Wwt, Ww^Vm, Wwrt, Wot, Wot, Wot, Wot, Wot, Wot, Wot, Wot, Wot, Wot
Wot, Wot, Wot, Wot, Wot, Wot, Wot, Wot, Wot, Wwt, Wwrt, Wwrt, Wot, Wot, Wot, Wwrt, Wwrt, Wwt, Wwt, Wwt, Wwt, Wwt, Ds, Ds, Ds, Ds, Wwt, Ds, Gd, Gd, Gd, Gd, Hh, Hh, Wwrt, Wwt, Wwt, Wwrt, Wwrt, Wot, Wot, Wot, Wot, Wot, Wot, Wot, Wot, Wot, Wot
Wot, Wot, Wot, Wot, Wot, Wot, Wot, Wot, Wot, Wot, Wot, Wot, Wot, Wot, Wot, Wot, Wwt, Wwt, Wwt, Wwt, Wwt, Wwt, Wwt, Wwt, Wwt, Wwt, Wwt, Ds, Ds, Ds, Ds, Dd^Esd, Hh, Hh, Wwt, Wwrt, Wwt, Wwrt, Wwt, Wot, Wot, Wot, Wot, Wot, Wot, Wot, Wot, Wot, Wot
Wot, Wot, Wot, Wot, Wot, Wot, Wot, Wot, Wot, Wot, Wot, Wot, Wot, Wot, Wot, Wot, Wot, Wwt, Wot, Wwt, Wwt, Wwt, Wwt, Wwt, Wwt, Wwt, Wwt, Wwt, Wwt, Wwt, Ds, Dd, Wwt, Wwrt, Wwrt, Wwt, Wwrt, Wwt, Wot, Wot, Wot, Wot, Wot, Wot, Wot, Wot, Wot, Wot, Wot
Wot, Wot, Wot, Wot, Wot, Wot, Wot, Wot, Wot, Wot, Wot, Wot, Wot, Wot, Wot, Wot, Wot, Wot, Wot, Wwt, Wot, Wwt, Wwt, Wwt, Wwt, Wwt, Wwt, Wwt, Wwt, Wwt, Wwt, Wwt, Wwt, Wwt, Wwrt, Wwrt, Wwrt, Wot, Wot, Wot, Wot, Wot, Wot, Wot, Wot, Wot, Wot, Wot, Wot
Wot, Wot, Wot, Wot, Wot, Wot, Wot, Wot, Wot, Wot, Wot, Wot, Wot, Wot, Wot, Wot, Wot, Wot, Wot, Wot, Wot, Wot, Wot, Wot, Wot, Wwt, Wwt, Wwt, Wwt, Wwt, Wwt, Wwt, Wwrt, Wwt, Wot, Wot, Wot, Wot, Wot, Wot, Wot, Wot, Wot, Wot, Wot, Wot, Wot, Wot, Wot
Wot, Wot, Wot, Wot, Wot, Wot, Wot, Wot, Wot, Wot, Wot, Wot, Wot, Wot, Wot, Wot, Wot, Wot, Wot, Wot, Wot, Wot, Wot, Wot, Wot, Wot, Wot, Wot, Wot, Wwt, Wwrt, Wwrt, Wot, Wwrt, Wot, Wot, Wot, Wot, Wot, Wot, Wot, Wot, Wot, Wot, Wot, Wot, Wot, Wot, Wot
Wot, Wot, Wot, Wot, Wot, Wot, Wot, Wot, Wot, Wot, Wot, Wot, Wot, Wot, Wot, Wot, Wot, Wot, Wot, Wot, Wot, Wot, Wot, Wot, Wot, Wot, Wot, Wot, Wot, Wwt, Wot, Wot, Wot, Wot, Wot, Wot, Wot, Wot, Wot, Wot, Wot, Wot, Wot, Wot, Wot, Wot, Wot, Wot, Wot
Wot, Wot, Wot, Wot, Wot, Wot, Wot, Wot, Wot, Wot, Wot, Wot, Wot, Wot, Wot, Wot, Wot, Wot, Wot, Wot, Wot, Wot, Wot, Wot, Wot, Wot, Wot, Wot, Wot, Wot, Wot, Wot, Wot, Wot, Wot, Wot, Wot, Wot, Wot, Wot, Wot, Wot, Wot, Wot, Wot, Wot, Wot, Wot, Wot
Wot, Wot, Wot, Wot, Wot, Wot, Wot, Wot, Wot, Wot, Wot, Wot, Wot, Wot, Wot, Wot, Wot, Wot, Wot, Wot, Wot, Wot, Wot, Wot, Wot, Wot, Wot, Wot, Wot, Wot, Wot, Wot, Wot, Wot, Wot, Wot, Wot, Wot, Wot, Wot, Wot, Wot, Wot, Wot, Wot, Wot, Wot, Wot, Wot
