Wo, Wo, Wo, Wo, Wo, Wo, Wo, Wo, Wo, Wo, Wo, Wo, Wo, Wo, Wo, Wo, Wo, Wo, Wo, Wo, Wo, Wo, Wo, Wo, Wo, Wo, Wo, Wo, Wo, Wo, Wo, Wo, Wo, Wo, Wo, Wo, Wo, Wo, Wo, Wo, Wo, Wo, Wo, Wo, Wo, Wo, Wo
Wo, Wo, Wo, Wo, Wo, Wo, Wo, Wo, Wo, Wo, Wo, Wo, Wo, Wo, Wo, Wo, Wo, Wo, Wo, Wo, Wo, Wo, Wo, Wo, Wo, Wo, Wo, Wo, Wo, Wo, Wo, Wo, Wo, Wo, Wo, Wo, Wo, Wo, Wo, Wo, Wo, Wo, Wo, Wo, Wo, Wo, Wo
Wo, Wo, Wo, Wo, Wo, Wo, Wo, Wo, Wo, Wo, Wo, Wo, Wo, Wo, Wo, Wo, Wo, Wo, Wo, Wo, Wo, Wo, Wo, Wo, Wo, Wo, Wo, Wo, Wo, Wo, Wo, Wo, Ww, Ww, Ww, Ww, Ww, Wo, Wo, Wo, Wo, Wo, Wo, Wo, Wo, Wo, Wo
Wo, Wo, Wo, Wo, Wo, Wo, Wo, Wo, Wo, Wo, Wo, Wo, Wo, Wo, Wo, Wo, Wo, Wo, Wo, Wo, Wo, Wo, Wo, Wo, Wo, Wo, Wo, Wo, Wo, Wo, Ww, Ww, Ds, Ds, Ds, Ds, Ds, Ww, Ww, Wo, Wo, Wo, Wo, Wo, Wo, Wo, Wo
Wo, Wo, Wo, Wo, Wo, Wo, Wo, Wo, Wo, Wo, Wo, Wo, Wo, Wo, Wo, Wo, Wo, Wo, Wo, Wo, Wo, Wo, Ww, Ww, Ww, Ww, Ww, Ww, Ww, Ww, Ds, Ds, Gs, Gs, Gs, Gs, Gs, Ds, Ds, Ww, Wo, Wo, Wo, Wo, Wo, Wo, Wo
Wo, Wo, Wo, Wo, Wo, Wo, Wo, Wo, Wo, Wo, Wo, Wo, Wo, Wo, Wo, Wo, Wo, Wo, Ww, Ww, Ww, Ww, Ds, Ww, Ds, Ds, Ds, Ds, Ds, Ds, Gs^Ft, Gs^Ft, Gs^Ft, Gs^Ft, Gs^Ft, Gs^Ft, Gs^Ft, Gs, Ds, Ww, Ww, Wo, Wo, Wo, Wo, Wo, Wo
Wo, Wo, Wo, Wo, Wo, Wo, Wo, Wo, Wo, Wo, Wo, Wo, Wo, Wo, Wo, Wo, Ww, Ww, Ds, Ds, Ds, Ds, Gs, Ds, Gs^Ft, Gs^Ft, Gs, Ds, Rd, Rd, Gs^Ft, Gs^Ft, Gs^Ft, Gs^Ft, Gs^Ft, Gs^Ft, Gs, Gs, Gs, Ds, Ww, Wo, Wo, Wo, Wo, Wo, Wo
Wo, Wo, Wo, Wo, Wo, Wo, Wo, Wo, Wo, Wo, Wo, Wo, Wo, Wo, Wo, Wo, Ww, Ds, Gs^Ft, Gs^Ft, Gs^Ft, Gs^Ft, Gs^Ft, Gs^Vht, Gs^Ft, Gs^Ft, Gs^Ft, Gs, Gs^Ft, Gs^Ft, Gs^Ft, Gs^Ft, Gs^Ft, Gs^Ft, Gs^Ft, Gs^Ft, Gs^Ft, Gs^Ft, Gs^Ft, Ds, Ww, Wo, Wo, Wo, Wo, Wo, Wo
Wo, Wo, Wo, Wo, Wo, Wo, Wo, Wo, Wo, Wo, Wo, Wo, Wo, Wo, Wo, Ww, Ds, Ds, Gs^Ft, Gs^Ft, Gll^Ftr, Gs^Ft, Gs^Ft, Gs^Ft, Gs^Ft, Gs^Ft, Gs^Ft, Gs, Gs^Ft, Gs^Ft, Gs^Ft, Gs^Ft, Gs^Ft, Gs^Ft, Gs^Ft, Gs^Ft, Gs^Ft, Gs^Ft, Ds, Ds, Ww, Wo, Wo, Wo, Wo, Wo, Wo
Wo, Wo, Wo, Wo, Wo, Wo, Wo, Wo, Wo, Wo, Wo, Wo, Wo, Wo, Ww, Ww, Ds, Gs^Ft, Gs^Ft, Gll^Ftr, Gll^Ftr, Gs^Ft, Gll^Ftr, Gs^Ft, Gs^Ft, Gs^Ft, Gs^Ft, Gs^Ft, Gs^Ft, Gs^Ft, Gs^Vht, Gs^Ft, Gs^Ft, Gs^Ft, Gs^Ft, Gs^Ft, Gs^Ft, Gs^Ft, Ds, Ww, Ww, Wo, Wwr, Wo, Wo, Wo, Wo
Wo, Wo, Wo, Wo, Wo, Wo, Wo, Wo, Wo, Wo, Wo, Wo, Ww, Ww, Ss, Ww, Ww, Gs^Ft, Gll^Ftr, Ss, Gs^Ft, Ww, Ww, Gs^Ft, Gs^Ft, Gs^Ft, Gs^Ft, Gs^Ft, Gs^Ft, Gs^Em, Gs^Ft, Gs^Ft, Gs^Ft, Gs^Ft, Gs^Ft, Gs^Ft, Gs^Ft, Hh, Hd, Ww, Ww, Ww, Wwr, Wo, Wo, Wo, Wo
Wo, Wo, Wo, Wo, Wo, Wo, Wo, Wo, Wo, Wo, Wo, Ww, Ww, Ss, Gs^Ft, Gs^Ft, Gll^Ftr, Gll^Ftr, Ss, Gs^Ft, Gll^Ftr, Gs^Ft, Ss, Gs^Ft, Gll^Ftr, Ss, Ss, Hh^Ft, Hh^Ft, Gs^Ft, Mm, Hh^Ft, Hh, Hh^Ft, Gs^Ft, Gs^Ft, Gs^Ft, Hh, Hh^Ft, Hd, Ww, Wwr, Wo, Wo, Wo, Wo, Wo
Wo, Wo, Wo, Wo, Wo, Wo, Wo, Wo, Wo, Wo, Ww, Ww, Ss, Ss, Ss, Gs^Ft, Gs^Ft, Ss, Gll^Ftr, Gll^Ftr, Ww, Ss, Gll^Ftr, Gs^Ft, Gs^Ft, Gs^Ft, Gs^Ft, Gs^Ft, Hh^Ft, Hh^Ft, Mm, Mm, Mm, Gs^Ft, Gs^Ft, Hh, Hh, Hh^Ft, Hd, Hd, Ww, Wwr, Wo, Wo, Wo, Wo, Wo
Wo, Wo, Wo, Wo, Wo, Wo, Wo, Wo, Wo, Wo, Ww, Ww, Ss, Gs^Ft, Gs^Ft, Ww, Gll^Ftr, Gll^Ftr, Gll^Ftr, Ss^Vhs, Gll^Ftr, Gll^Ftr, Gll^Ftr, Gll^Ftr, Gs^Ft, Ww, Ww, Ss, Ss, Hh^Ft, Hh, Mm, Hh^Ft, Hh^Ft, Hh^Ft, Hh, Mm, Hh^Ft, Hd, Ww, Ww, Wo, Wo, Wo, Wo, Wo, Wo
Wo, Wo, Wo, Wo, Wo, Wo, Wo, Wo, Wo, Wo, Ww, Ww, Ww, Ss, Ss, Gs^Ft, Ss, Ss, Gs^Ft, Gs^Ft, Ss, Ww, Gll^Ftr, Ss, Hh, Ss, Hh^Ft, Ss, Hh, Hh^Ft, Hh, Hh^Vc, Mm, Hh^Ft, Mm, Mm, Hd, Hd, Ww, Ww, Wo, Wo, Wo, Wo, Wo, Wo, Wo
Wo, Wo, Wo, Wo, Wo, Wo, Wo, Wo, Ww, Ww, Ww, Ss, Gs^Ft, Ww, Ww, Gs^Ft, Ww, Ww, Ww, Ww, Gs^Ft, Gll^Ftr, Ss, Ss, Hh^Ft, Ss, Mm, Hh^Ft, Hhd, Hhd, Mm, Mm, Mm, Mm, Mm, Mm, Hd, Ww, Ww, Wwr, Wo, Wo, Wo, Wo, Wo, Wo, Wo
Wo, Wo, Wo, Wo, Wo, Wo, Wo, Wo, Ww, Ss, Gs^Ft, Ss, Ss, Ss, Gs^Ft, Ww, Wo, Wo, Wo, Ww, Hh, Hh, Hh, Hh, Hh^Ft, Hh, Mm, Mm, Hh^Ft, Hhd, Hhd, Hd, Hd, Hd, Hd, Hd, Ww, Ww, Wwr, Wwr, Wo, Wo, Wo, Wo, Wo, Wo, Wo
Wo, Wo, Wo, Wo, Wo, Wo, Ww, Ww, Ww, Ss, Ss, Gll^Ftr, Gll^Ftr, Gs^Ft, Ww, Ww, Wo, Wo, Ww, Ww, Hh, Hh^Ft, Hh^Ft, Hh^Ft, Mm, Hh, Hh^Ft, Hh, Hh, Hh, Hd, Hd, Ww, Hd, Hd, Hd, Hd, Ww, Ww, Wwr, Wwr, Wo, Wo, Wo, Wo, Wo, Wo
Wo, Wo, Wo, Wo, Wo, Wo, Ww, Ss, Gs^Ft, Gs^Ft, Gll^Ftr, Gll^Ftr, Ss, Ss, Gs^Ft, Ww, Ww, Ww, Ww^Es, Mm, Hh, Hh, Mm, Mm, Mm, Hh, Hh^Ft, Hh^Ft, Mm, Hd, Hd, Ww, Ww^Vm, Ww, Ww, Ww, Ww, Ww, Ww, Ww, Wwr, Wo, Wo, Wo, Wo, Wo, Wo
Wo, Wo, Wo, Wo, Wo, Ww, Ds, Ss, Gs^Ft, Ss, Ss, Gll^Ftr, Ss^Vhs, Gll^Ftr, Ss, Ww, Hh, Mm, Mm, Mm, Mm, Hh^Vc, Mm, Mm, Hh^Ft, Hh, Mm, Hh^Ft, Mm, Hh^Ft, Hd, Ww, Ww, Ww, Ww, Ww, Ww, Ww, Hd, Ww, Wo, Wo, Wo, Wo, Wo, Wo, Wo
Wo, Wo, Wo, Wo, Ww, Ww, Wwf, Ds, Gs^Ft, Gs^Ft, Gll^Ftr, Gs^Ft, Gll^Ftr, Gll^Ftr, Gg^Ft, Gs^Ft, Gs^Ft, Hh^Ft, Hhd, Hhd, Mm, Mm, Mm, Mm, Mm, Hh^Ft, Hh, Mm, Mm, Hh^Ft, Hhd, Hd, Ww, Hd, Hd, Ww, Ww, Hd, Hd, Ww, Ww, Wwr, Wo, Wo, Wo, Wo, Wo
Wo, Wo, Wo, Wo, Ww, Gs^Ft, Wwf, Ds, Ss, Ss, Gll^Ftr, Gs^Ft, Ss, Ss, Gll^Ftr, Gs^Ft, Gs^Ft, Hhd, Hh^Ft, Hh^Ft, Hh^Ft, Mm, Hd, Mm, Hh^Ft, Hh^Ft, Hh^Ft, Mm, Mm, Md, Hhd, Hd, Hd, Hd, Hd, Ww, Ww, Ww^Vm, Hd, Ww, Wo, Wwr, Wo, Wo, Wo, Wo, Wo
Wo, Wo, Wo, Ww, Ds, Gs^Ft, Gs^Ft, Ww, Ds, Ss, Gs^Ft, Gs^Ft, Gs^Ft, Gs^Ft, Gs^Em, Gs^Ft, Gs^Ft, Gs^Ft, Hh^Ft, Hh^Ft, Hh^Ft, Hh^Ft, Hd, Ww, Hh^Ft, Hh^Ft, Hh^Vc, Mm, Mm, Mm, Hh^Ft, Hhd, Mm, Mm, Hd, Hd, Ww, Ww, Ww, Ww, Wo, Wo, Wo, Wo, Wo, Wo, Wo
Wo, Wo, Wo, Ww, Ds, Gs^Ft, Ww, Ww, Ds, Gs^Ft, Gs^Ft, Gs^Ft, Gs, Gs, Gs, Gs^Ft, Gs^Ft, Gs^Ft, Gs^Ft, Hh^Ft, Ss, Ss, Ww, Ww, Hh^Ft, Hh^Ft, Hh^Ft, Hh, Hh^Ft, Mm, Mm, Mm, Mm, Mm, Hd, Hd, Ww, Wwr, Wwr, Wwr, Wo, Wo, Wo, Wo, Wo, Wo, Wo
Wo, Wo, Wo, Ww, Ww, Ds, Ww, Ds, Gs^Ft, Gs^Ft, Gs^Ft, Gs^Ft, Ds, Ds, Ds, Gs^Ft, Gs, Gs^Vht, Gs^Ft, Gs^Ft, Ss, Ww, Ss, Ss, Hh^Ft, Hh^Ft, Hh^Ft, Hh, Mm, Mm, Mm, Mm, Mm, Mm, Hd, Ww, Wwr, Wwr, Wo, Wo, Wo, Wo, Wo, Wo, Wo, Wo, Wo
Wo, Wo, Wo, Wo, Ww, Ww, Ds, Ds, Gs^Ft, Gs^Ft, Ds, Ds, Ww, Ww, Ww, Ds, Gs, Rd, Rd, Ss, Ww, Ww, Gs^Ft, Gs^Ft, Gs^Ft, Hh, Hh^Ft, Hh^Ft, Mm, Mm, Mm, Mm, Hd, Hd, Ww, Ww, Wwr, Wo, Wo, Wo, Wo, Wo, Wo, Wo, Wo, Wo, Wo
Wo, Wo, Wo, Wo, Wo, Ww, Ds, Gs^Ft, Gs^Vht, Gs, Ds, Ww, Ww, Ww, Ww, Ds, Gs, Gs^Ft, Ss, Wwf, Ss, Gs^Ft, Gs^Ft, Gs^Ft, Gs^Ft, Hh, Hd, Hd, Ww, Mm, Mm, Mm, Hd, Hd, Ww, Wwr, Wwr, Wo, Wo, Wo, Wo, Wo, Wo, Wo, Wo, Wo, Wo
Wo, Wo, Wo, Wo, Wo, Ww, Ds, Gs^Ft, Gs^Ft, Ds, Ww, Ww, Ww, Ww, Ds, Ds, Gs^Ft, Gs^Ft, Ww, Ww, Gs^Ft, Gs^Ft, Gs^Ft, Gs^Vht, Gs^Ft, Hh^Ft, Ww, Ww, Hd, Mm, Mm, Hd, Hd, Ww, Ww, Ww, Wo, Wo, Wo, Wo, Wo, Wo, Wo, Wo, Wo, Wo, Wo
Wo, Wo, Wo, Wo, Wo, Ww, Ww, Ds, Gs^Ft, Ds, Ww, Ww, Ww, Ww, Ds, Gs^Ft, Gs^Ft, Gs^Ft, Gs^Ft, Ww, Ss, Gs^Ft, Gs^Ft, Gs^Ft, Gs^Ft, Gs^Ft, Ww, Ss, Hhd, Hhd, Hhd, Hhd, Hd, Ww, Ww, Wwr, Wo, Wo, Wo, Wo, Wo, Wo, Wo, Wo, Wo, Wo, Wo
Wo, Wo, Wo, Wo, Wo, Wo, Ww, Ds, Ds^Ewsh, Ds, Wwf, Ww, Ww, Ww, Ww, Ds, Ds, Gs^Ft, Ss, Ww, Ww, Ss, Gs^Ft, Gs^Ft, Gs^Ft, Wwf, Ss, Ss, Hh^Ft, Hh^Ft, Mm, Hd, Ww, Ww, Wwr, Wwr, Wwr, Wo, Wo, Wo, Wo, Wo, Wo, Wo, Wo, Wo, Wo
Wo, Wo, Wo, Wo, Wo, Wo, Wo, Ww, Ww, Ds, Wwf, Ww, Ww, Ww, Ww, Ds, Ww^Vm, Ds, Ds, Ww, Ds, Ss, Gs^Ft, Ss, Ww, Ww, Ss, Gs^Ft, Hh^Ft, Hh, Mm, Hd, Hd, Ww, Ww, Wwr, Wo, Wo, Wo, Wo, Wo, Wo, Wo, Wo, Wo, Wo, Wo
Wo, Wo, Wo, Wo, Wo, Wo, Wo, Wo, Wo, Ww, Ds, Ds, Ww, Ww, Ww, Ww, Ww, Ds, Ww, Ww, Ds, Gs^Ft, Gs^Ft, Ss, Ww, Ss, Gs^Ft, Gs^Ft, Gs^Ft, Hh^Ft, Hh^Ft, Hh^Ft, Hd, Ww, Wwr, Wwr, Wo, Wo, Wo, Wo, Wo, Wo, Wo, Wo, Wo, Wo, Wo
Wo, Wo, Wo, Wo, Wo, Wo, Wo, Wo, Wo, Ww, Ww, Ds^Ewsh, Ww, Ww, Ww, Ww, Ww, Ww, Ww, Ww, Ds, Ds, Ds, Ss, Ww, Ss, Gs^Ft, Gs^Vht, Gs^Ft, Hh^Ft, Hh^Ft, Hd, Ww, Ww, Wo, Wwr, Wo, Wo, Wo, Wo, Wo, Wo, Wo, Wo, Wo, Wo, Wo
Wo, Wo, Wo, Wo, Wo, Wo, Wo, Wo, Wo, Wo, Ww, Ds^Ewsh, Ds, Wwf, Ds, Ww, Ww, Ww, Ww, Ww, Ww, Ww, Ww, Ww, Ww, Ds, Ds, Ds, Ds, Hh^Ft, Hd, Hd, Ww, Ww, Wwr, Wo, Wo, Wo, Wo, Wo, Wo, Wo, Wo, Wo, Wo, Wo, Wo
Wo, Wo, Wo, Wo, Wo, Wo, Wo, Wo, Wo, Wo, Wo, Ww, Ww, Ww, Ww, Ds^Ewsh, Ds^Ewsh, Wwf, Ds, Ds, Ww, Ww, Ww, Ww, Ww, Ww, Ww, Ww, Ds, Hd, Ww, Ww, Ww, Wwr, Wo, Wo, Wo, Wo, Wo, Wo, Wo, Wo, Wo, Wo, Wo, Wo, Wo
Wo, Wo, Wo, Wo, Wo, Wo, Wo, Wo, Wo, Wo, Wo, Wo, Wo, Ww, Wo, Ww, Ww, Ww, Ww, Ds^Ewsh, Ww, Ww, Wwr, Ww, Ww, Ww, Wwr, Ww, Ww, Ww, Ww, Wwr, Wo, Wwr, Wo, Wo, Wo, Wo, Wo, Wo, Wo, Wo, Wo, Wo, Wo, Wo, Wo
Wo, Wo, Wo, Wo, Wo, Wo, Wo, Wo, Wo, Wo, Wo, Wo, Wo, Wo, Wo, Wo, Wo, Wo, Wo, Ww, Wo, Wwr, Wo, Wwr, Wo, Wwr, Wwr, Wwr, Wwr, Wwr, Wo, Wo, Wo, Wo, Wo, Wo, Wo, Wo, Wo, Wo, Wo, Wo, Wo, Wo, Wo, Wo, Wo
Wo, Wo, Wo, Wo, Wo, Wo, Wo, Wo, Wo, Wo, Wo, Wo, Wo, Wo, Wo, Wo, Wo, Wo, Wo, Wo, Wo, Wo, Wo, Wo, Wo, Wo, Wo, Wo, Wo, Wo, Wo, Wo, Wo, Wo, Wo, Wo, Wo, Wo, Wo, Wo, Wo, Wo, Wo, Wo, Wo, Wo, Wo
Wo, Wo, Wo, Wo, Wo, Wo, Wo, Wo, Wo, Wo, Wo, Wo, Wo, Wo, Wo, Wo, Wo, Wo, Wo, Wo, Wo, Wo, Wo, Wo, Wo, Wo, Wo, Wo, Wo, Wo, Wo, Wo, Wo, Wo, Wo, Wo, Wo, Wo, Wo, Wo, Wo, Wo, Wo, Wo, Wo, Wo, Wo
