Wot, Wot, Wot, Wot, Wot, Wot, Wot, Wot, Wot, Wot, Wot, Wot, Wot, Wot, Wot, Wot, Wot, Wot, Wot, Wot, Wot, Wot, Wot, Wot, Wot, Wot, Wot, Wot, Wwt, Wot, Wot, Wot, Wot, Wot, Wot, Wot, Wot, Wot, Wot, Wot, Wot, Wot, Wot, Wot, Wot, Wot, Wot
Wot, Wot, Wot, Wot, Wot, Wot, Wot, Wot, Wot, Wot, Wot, Wot, Wot, Wot, Wot, Wot, Wot, Wot, Wot, Wot, Wot, Wot, Wot, Wot, Wot, Wot, Wwt, Wwt, Rb, Wwt, Wwt, Wot, Wot, Wot, Wot, Wot, Wot, Wot, Wot, Wot, Wot, Wot, Wot, Wot, Wot, Wot, Wot
Wot, Wot, Wot, Wot, Wot, Wot, Wot, Wot, Wot, Wot, Wot, Wot, Wot, Wot, Wot, Wot, Wot, Wot, Wot, Wot, Wot, Wot, Wwt, Wwt, Rb, Wwt, Wwrt, Gg, Hh, Gd, Wwrt, Wwt, Wwt, Wot, Wot, Wot, Wot, Wot, Wot, Wot, Wot, Wot, Wot, Wot, Wot, Wot, Wot
Wot, Wot, Wot, Wot, Wot, Wot, Wot, Wot, Wot, Wot, Wot, Wot, Wot, Wot, Wot, Wot, Wot, Wot, Wot, Wot, Wot, Wot, Wot, Wwt, Gg, Gg, Hh, Hh, Mm, Hh, Hh, Rb, Gg, Wwt, Wwt, Wot, Wot, Wot, Wot, Wot, Wot, Wot, Wot, Wot, Wot, Wot, Wot
Wot, Wot, Wot, Wot, Wot, Wot, Wot, Wot, Wot, Wot, Wot, Wot, Wot, Wot, Wot, Wot, Wot, Wot, Wot, Wot, Wot, Wot, Wot, Wwt, Wwt, Gll^Ftr, Gll^Ftr, Hh, Hh^Ftr, Hh, Hh, Gg, Gll^Ftr, Gll^Ftr, Gll^Ftr, Wwt, Wot, Wot, Wot, Wot, Wot, Wot, Wot, Wot, Wot, Wot, Wot
Wot, Wot, Wot, Wot, Wot, Wot, Wot, Wot, Wot, Wot, Wot, Wot, Wot, Wot, Wot, Wot, Wot, Wot, Wot, Wot, Wot, Wot, Wot, Wot, Wwt, Rb, Rb, Gll^Ftr, Gll^Ftr, Hh^Ftr, Hh, Hh, Gg, Gll^Ftr, Wwt, Wwt, Wot, Wot, Wot, Wot, Wot, Wot, Wot, Wot, Wot, Wot, Wot
Wot, Wot, Wot, Wot, Wot, Wot, Wot, Wot, Wot, Wot, Wot, Wot, Wot, Wot, Wot, Wot, Rb, Rb, Rb, Rb, Re, Wot, Wot, Wot, Wot, Wwt, Rb, Gg, Gg, Gll^Ftr, Gll^Ftr, Gg, Wwf, Wwt, Wot, Wot, Wot, Wot, Wot, Wot, Wot, Wot, Wot, Wot, Wot, Wot, Wot
Wot, Wot, Wot, Wot, Wot, Wot, Wot, Wot, Wot, Wot, Wot, Wot, Wot, Wot, Wot, Re, Re, Wot, Wot, Wwt, Wwt, Re, Re, Wot, Wot, Wwt, Rb, Gd, Wwt, Gg, Gg, Gg, Wwt, Wwf, Ds, Wot, Ds, Wot, Wot, Wot, Wot, Wot, Wot, Wot, Wot, Wot, Wot
Wot, Wot, Wot, Wot, Wot, Wot, Wot, Wot, Wot, Wot, Wot, Wot, Wot, Wot, Rb, Gd, Gd, Wot, Wwt, Wwt, Ww^Vm, Wwt, Wwt, Rb, Rb, Wwt, Wwt, Wwt, Wwt, Wwt, Wwt, Wwt, Wwt, Wwt, Ds, Ds, Ds, Wot, Wot, Wot, Wot, Wot, Wot, Wot, Wot, Wot, Wot
Wot, Wot, Wot, Wot, Wot, Wot, Wot, Wot, Wot, Wot, Wot, Wot, Cm, Rb, Gs, Gd, Gd, Gd, Re, Wwt, Wwt, Wwt, Rb, Rb, Wot, Wot, Wot, Wwt, Wot, Wwt, Wot, Wot, Wot, Ds, Wwt, Wwt, Ww^Vm, Ds, Wot, Wot, Wot, Wot, Wot, Wot, Wot, Wot, Wot
Wot, Wot, Wot, Wot, Wot, Wot, Wot, Wot, Wot, Wot, Cm, Wot, Wwt, Rb, Wot, Gs, Ww^Vm, Gd, Wot, Re, Re, Rb, Rb, Rb, Wot, Wot, Wot, Wot, Wot, Wot, Wot, Wot, Ds, Ds, Wwt, Wot, Wwt, Ds, Ds, Wot, Wot, Wot, Wot, Wot, Wot, Wot, Wot
Wot, Wot, Wot, Wot, Wot, Wot, Wot, Ds, Ds, Ds, Ds, Wwt, Wot, Wot, Wot, Wot, Wot, Wot, Wot, Wot, Wot, Wot, Wot, Wot, Wot, Wot, Wot, Wot, Wot, Wot, Wot, Wot, Ds, Ds, Ds, Wwt, Wwt, Wwt, Ds, Wot, Wot, Wot, Wot, Wot, Wot, Wot, Wot
Wot, Wot, Wot, Wot, Wot, Wot, Wot, Ds, Wwt, Dd^Do, Ds, Wot, Wot, Wot, Wot, Wot, Wot, Wot, Wot, Wot, Wot, Wot, Wot, Wot, Wot, Wot, Wot, Wot, Wot, Wot, Wot, Wot, Wot, Ww^Vm, Wot, Ds, Ds, Ds, Ds, Wot, Wot, Wot, Wot, Wot, Wot, Wot, Wot
Wot, Wot, Wot, Wot, Wot, Wot, Wot, Ds, Ds, Ds, Ds, Ds, Ww^Vm, Wot, Wot, Wot, Wot, Wot, Wot, Wot, Wwt, Wot, Wwt, Wot, Wot, Wot, Wot, Wot, Wot, Wot, Wot, Wot, Wot, Wot, Wot, Wot, Wwt, Cm, Wot, Wot, Wot, Wot, Wot, Wot, Wot, Wot, Wot
Wot, Wot, Wot, Wot, Wot, Wot, Wot, Wwt, Ds, Ds, Ds, Ds, Ds, Wot, Wot, Wot, Wot, Wot, Wot, Wwt, Ds, Wwt, Ds, Wwt, Cm, Wot, Wwrt, Wot, Cm, Wot, Wot, Wot, Wot, Wot, Wot, Wot, Wwt, Wot, Wot, Wot, Wot, Wot, Wot, Wot, Wot, Wot, Wot
Wot, Wot, Wot, Wot, Wot, Wot, Wot, Wwt, Ds, Ds, Ds, Ds, Ds, Wot, Wwt, Wot, Wot, Wot, Wwt, Wwt, Ds, Ds, Ds, Ds, Ds, Wwrt, Wwt, Wwrt, Ds, Wwt, Wwt, Wot, Wot, Wot, Wot, Wot, Ds, Cm, Wot, Wot, Wot, Wot, Wot, Wot, Wot, Wot, Wot
Wot, Wot, Wot, Wot, Wot, Wot, Wot, Wwt, Ww^Vm, Ds, Ds, Wot, Ds, Wwt, Wwrt, Wwt, Wwt, Wwt, Wwt, Ds, Ds, Ds, Ww^Vm, Ds, Wwf, Wwrt, Ww, Wwrt, Wwrt, Ds, Ds, Wwt, Wwt, Wot, Ww^Vm, Rd, Ds, Ds, Ds, Wot, Wot, Wot, Wot, Wot, Wot, Wot, Wot
Wot, Wot, Wot, Wot, Wot, Wot, Wot, Wot, Wwt, Ds, Ds, Ds, Wwt, Wwrt, Ds, Ds, Wwt, Wwt, Wwrt, Ds, Wwf, Wwrt, Wwt, Wwt, Wwf, Wwt, Wwt, Wwt, Wwt, Ds, Wwrt, Ds, Wwt, Wot, Wot, Rd, Rd, Wot, Ds, Wot, Wot, Wot, Wot, Wot, Wot, Wot, Wot
Wot, Wot, Wot, Wot, Wot, Wot, Wot, Wot, Wwt, Ds, Ds, Ds, Wwrt, Wwt, Wwt, Ds, Wwt, Wwt, Wwrt, Wwt, Wwt, Wwf, Wwf, Wwf, Wwt, Wwt, Wwf, Wwf, Wwf, Wwf, Wwt, Wwrt, Wwrt, Wwt, Wot, Wot, Ds, Ds, Ds, Wot, Wot, Wot, Wot, Wot, Wot, Wot, Wot
Wot, Wot, Wot, Wot, Wot, Wot, Wot, Wot, Wot, Wwt, Ds, Ds, Wwt, Wwrt, Wwrt, Wwf, Wwt, Wwt, Wwrt, Wwt, Wwt, Ww, Wwt, Wwf, Cm, Cm, Cm, Wwt, Wwf, Ww, Wwt, Wwt, Ds, Wwt, Wwt, Wot, Ds, Ds, Wot, Wot, Wot, Wot, Wot, Wot, Wot, Wot, Wot
Wot, Wot, Wot, Wot, Wot, Wot, Wot, Wot, Wot, Wwt, Cm, Wwt, Wwt, Wwt, Ds, Wwf, Wwrt, Wwrt, Ds, Wwt, Wwt, Wwf, Wwt, Cm, Cm, Km, Cm, Cm, Wwf, Wwt, Ds, Ds, Ds, Ds, Wwt, Wwt, Wwrt, Ds, Wwt, Wot, Wot, Wot, Wot, Wot, Wot, Wot, Wot
Wot, Wot, Wot, Wot, Wot, Wot, Wot, Wot, Wot, Wot, Wot, Wwt, Cm, Ds, Ds, Wwt, Wwt, Wwt, Ds, Wwt, Ds, Ds, Wwt, Ww^Vm, Wwf, Cm, Wwt, Wwt, Ds, Ds, Wwt, Wwt, Wwt, Ds, Ds, Wwt, Wwrt, Wwt, Wwt, Wot, Wot, Wot, Wot, Wot, Wot, Wot, Wot
Wot, Wot, Wot, Wot, Wot, Wot, Wot, Wot, Wot, Wot, Wot, Wwt, Wwt, Wwt, Wwt, Wwt, Wwt, Wwrt, Wwt, Ds, Ds, Ds, Ds, Wwf, Wwt, Wwf, Wwf, Ww^Vm, Ds, Wwt, Wwt, Wwt, Wwt, Wwt, Ds, Wwrt, Wwt, Wwt, Wot, Wot, Wot, Wot, Wot, Wot, Wot, Wot, Wot
Wot, Wot, Wot, Wot, Wot, Wot, Wot, Wot, Wot, Wot, Wot, Wot, Wwt, Wot, Wot, Wot, Wot, Wwt, Wwt, Wwrt, Wwt, Ds, Ds, Wwrt, Wwrt, Wwrt, Wwrt, Ds, Ds, Wwt, Ds, Wwt, Ds, Ds, Wwt, Wwt, Wot, Wot, Wot, Wot, Wot, Wot, Wot, Wot, Wot, Wot, Wot
Wot, Wot, Wot, Wot, Wot, Wot, Wot, Wot, Wot, Wot, Wwt, Wwt, Cm, Wwt, Wwt, Wot, Wot, Wot, Wot, Wwt, Wwt, Wwrt, Cm, Wwt, Wwt, Wwrt, Cm, Ds, Wwt, Ds, Wwrt, Ds, Wwt, Wwt, Wot, Wot, Wot, Wot, Wot, Wot, Wot, Wot, Wot, Wot, Wot, Wot, Wot
Wot, Wot, Wot, Wot, Wot, Wot, Wot, Wot, Wot, Wwt, Ds, Ds, Ds, Wwt, Wwt, Wot, Wot, Wot, Wot, Wot, Wot, Wwt, Wwt, Wwt, Wwt, Wwt, Wot, Wwrt, Wwt, Wwt, Wwrt, Wwt, Wwt, Wot, Wot, Wot, Wot, Wot, Wot, Wot, Wot, Wot, Wot, Wot, Wot, Wot, Wot
Wot, Wot, Wot, Wot, Wot, Wot, Wot, Wot, Wot, Wot, Wwt, Ds, Ds, Ds, Wwf, Wwt, Wwt, Wot, Wot, Wot, Wot, Wot, Wot, Wot, Wot, Wot, Wot, Wwt, Wwt, Wwrt, Ds, Wwt, Ds, Wwt, Wwt, Wot, Wot, Wot, Wot, Wot, Wot, Wot, Wot, Wot, Wot, Wot, Wot
Wot, Wot, Wot, Wot, Wot, Wot, Wot, Wot, Wot, Wwt, Wwt, Ds, Wwt, Ds, Ds, Ds, Ds, Wwt, Wwt, Wot, Wot, Wot, Wot, Wot, Wot, Wot, Wot, Wwt, Ds, Ds, Ds, Ds, Wwt, Ds, Ds, Wwt, Wwt, Wot, Wot, Wot, Wot, Wot, Wot, Wot, Wot, Wot, Wot
Wot, Wot, Wot, Wot, Wot, Wot, Wot, Wot, Wot, Wwt, Wwt, Ds, Ds, Ds, Ds, Ds, Wwt, Ww^Vm, Wwt, Wot, Wot, Wot, Wot, Wot, Wot, Wot, Wwt, Wwt, Ds, Wwt, Wwt, Ww^Vm, Wot, Wwt, Wwf, Wwt, Wwt, Wwt, Wot, Wot, Wot, Wot, Wot, Wot, Wot, Wot, Wot
Wot, Wot, Wot, Wot, Wot, Wot, Wot, Wot, Wot, Wwt, Wwt, Wwt, Ww^Vm, Ds, Wwt, Ds, Ds, Ds, Wwt, Wot, Wot, Wot, Wot, Wot, Wwt, Wwt, Wwf, Ds, Wwt, Wot, Wot, Wot, Wot, Wwt, Ds, Wwt, Wwt, Wwt, Wot, Wot, Wwt, Wot, Wot, Wot, Wot, Wot, Wot
Wot, Wot, Wot, Wot, Wot, Wot, Wot, Wot, Wot, Wot, Wot, Wwt, Wwt, Ds, Ds, Ds, Ds, Ds, Wwt, Wot, Wot, Wot, Wwt, Wwt, Wwt, Gd, Gd, Wwf, Gd, Wwt, Ww^Vm, Wot, Wwt, Wwt, Ds, Wwt, Wot, Wot, Wwt, Wwt, Wwt, Wot, Wot, Wot, Wot, Wot, Wot
Wot, Wot, Wot, Wot, Wot, Wot, Wot, Wot, Wot, Wot, Wwt, Wwt, Wwt, Cm, Ds, Wwt, Ds, Ds, Wwt, Wot, Wot, Wot, Wwt, Ds^Ewsh, Gd, Gd, Wwt, Gd, Gd, Gd, Gd, Wwt, Wwt, Ds, Wwt, Wwt, Wot, Wot, Wwt, Wwt, Wwt, Wwt, Wwt, Wwt, Wwt, Wot, Wot
Wot, Wot, Wot, Wot, Wot, Wot, Wot, Wot, Wwt, Wwt, Cm, Wwt, Wwt, Wwt, Wwt, Ds, Ds, Wwt, Wwt, Wot, Wwt, Wwt, Gd, Gd, Wwt, Wwt, Gd, Gd, Gd, Gd, Wwt, Wwt, Rd, Wwt, Wwt, Wwt, Wot, Wwt, Wwt, Wwt, Ww^Vm, Gg, Hh, Rd, Wwt, Wot, Wot
Wot, Wot, Wot, Wot, Wot, Wot, Wot, Wwt, Ds, Ds, Ds, Wwt, Wot, Wot, Wot, Wwt, Wwt, Cm, Wwt, Wwt, Rd, Ww^Vm, Gd, Wwt, Gd, Gd, Gd, Gs^Ft, Gd, Gd, Wwt, Wwt, Rd, Wwt, Wwt, Wwt, Wot, Wwt, Wwt, Gg, Gg, Gg, Hh, Gd, Wwt, Wot, Wot
Wot, Wot, Wot, Wot, Wot, Wot, Wot, Wwt, Ds, Wwf, Ds, Wwt, Wwt, Wot, Wot, Wot, Wot, Wwt, Wwt, Cm, Rd, Rd, Wot, Wwt, Gd, Gd, Wwt, Ww^Vm, Wwt, Wwt, Rd, Rd, Wwt, Wwt, Wwt, Wot, Wwt, Wot, Wwt, Wwt, Gs, Hh, Gd, Gd, Wwt, Wot, Wot
Wot, Wot, Wot, Wot, Wot, Wot, Wot, Wwt, Wwt, Ds, Wwt, Ds, Ds, Wwt, Wwt, Wot, Wot, Wot, Wwt, Rd, Wwt, Wwt, Wwt, Gd, Wwt, Wwt, Rd, Wot, Rd, Rd, Rd, Rd, Wwt, Wwt, Wot, Wot, Wwt, Wwt, Wwf, Wwf, Wwt, Rd, Wwt, Wwt, Wot, Wot, Wot
Wot, Wot, Wot, Wot, Wot, Wot, Wot, Wot, Wwt, Ds, Ds, Wwt, Ds, Ww^Vm, Wwt, Wot, Wwt, Wwt, Wwr, Rd, Rd, Rd, Rd, Wwt, Rd, Rd, Rd, Rd, Wwt, Rd, Wwt, Wwt, Wwt, Wwt, Wot, Wwt, Rd, Rd, Wwt, Wwt, Wot, Wwt, Wot, Wot, Wot, Wot, Wot
Wot, Wot, Wot, Wot, Wot, Wot, Wot, Wot, Wwt, Wwt, Ds, Wwt, Ds, Ds, Cm, Wwt, Wwr, Wwr, Wwt, Wwr, Wwt, Rd, Cm, Rd, Wot, Wwt, Wwt, Wwt, Wwt, Wwt, Wwt, Wwt, Wot, Wot, Wot, Wwt, Rd, Hhd, Wwt, Wot, Wot, Wot, Wot, Wot, Wot, Wot, Wot
Wot, Wot, Wot, Wot, Wot, Wot, Wot, Wwt, Wot, Wwt, Wwt, Ds, Wwt, Ds, Wwr, Wwr, Wwt, Wwr, Wwt, Wot, Wot, Wwr, Wot, Wot, Wot, Wot, Wot, Wwt, Wwt, Wwt, Wot, Wot, Wot, Wot, Wot, Wwt, Wwt, Wwt, Wot, Wot, Wot, Wot, Wot, Wot, Wot, Wot, Wot
Wot, Wot, Wot, Wot, Wot, Wot, Wot, Wot, Wot, Wot, Wot, Wwt, Wot, Wwt, Wot, Wwt, Wot, Wwt, Wot, Wot, Wot, Wot, Wot, Wot, Wot, Wot, Wot, Wot, Wot, Wot, Wot, Wot, Wot, Wot, Wot, Wot, Wot, Wot, Wot, Wot, Wot, Wot, Wot, Wot, Wot, Wot, Wot
Wot, Wot, Wot, Wot, Wot, Wot, Wot, Wot, Wot, Wot, Wot, Wot, Wot, Wot, Wot, Wot, Wot, Wot, Wot, Wot, Wot, Wot, Wot, Wot, Wot, Wot, Wot, Wot, Wot, Wot, Wot, Wot, Wot, Wot, Wot, Wot, Wot, Wot, Wot, Wot, Wot, Wot, Wot, Wot, Wot, Wot, Wot
Wot, Wot, Wot, Wot, Wot, Wot, Wot, Wot, Wot, Wot, Wot, Wot, Wot, Wot, Wot, Wot, Wot, Wot, Wot, Wot, Wot, Wot, Wot, Wot, Wot, Wot, Wot, Wot, Wot, Wot, Wot, Wot, Wot, Wot, Wot, Wot, Wot, Wot, Wot, Wot, Wot, Wot, Wot, Wot, Wot, Wot, Wot
Wot, Wot, Wot, Wot, Wot, Wot, Wot, Wot, Wot, Wot, Wot, Wot, Wot, Wot, Wot, Wot, Wot, Wot, Wot, Wot, Wot, Wot, Wot, Wot, Wot, Wot, Wot, Wot, Wot, Wot, Wot, Wot, Wot, Wot, Wot, Wot, Wot, Wot, Wot, Wot, Wot, Wot, Wot, Wot, Wot, Wot, Wot
Wot, Wot, Wot, Wot, Wot, Wot, Wot, Wot, Wot, Wot, Wot, Wot, Wot, Wot, Wot, Wot, Wot, Wot, Wot, Wot, Wot, Wot, Wot, Wot, Wot, Wot, Wot, Wot, Wot, Wot, Wot, Wot, Wot, Wot, Wot, Wot, Wot, Wot, Wot, Wot, Wot, Wot, Wot, Wot, Wot, Wot, Wot
Wot, Wot, Wot, Wot, Wot, Wot, Wot, Wot, Wot, Wot, Wot, Wot, Wot, Wot, Wot, Wot, Wot, Wot, Wot, Wot, Wot, Wot, Wot, Wot, Wot, Wot, Wot, Wot, Wot, Wot, Wot, Wot, Wot, Wot, Wot, Wot, Wot, Wot, Wot, Wot, Wot, Wot, Wot, Wot, Wot, Wot, Wot
Wot, Wot, Wot, Wot, Wot, Wot, Wot, Wot, Wot, Wot, Wot, Wot, Wot, Wot, Wot, Wot, Wot, Wot, Wot, Wot, Wot, Wot, Wot, Wot, Wot, Wot, Wot, Wot, Wot, Wot, Wot, Wot, Wot, Wot, Wot, Wot, Wot, Wot, Wot, Wot, Wot, Wot, Wot, Wot, Wot, Wot, Wot
