Wot, Wot, Wot, Wot, Wot, Wot, Wot, Wot, Wot, Wot, Wot, Wot, Wot, Wot, Wot, Wot, Wot, Wot, Wot, Wot, Wot, Wot, Wot, Wot, Wot, Wot, Wot, Wot, Wwt, Wot, Wot, Wot, Wot, Wot, Wot, Wot, Wot, Wot, Wot, Wot, Wot, Wot, Wot, Wot, Wot, Wot, Wot
Wot, Wot, Wot, Wot, Wot, Wot, Wot, Wot, Wot, Wot, Wot, Wot, Wot, Wot, Wot, Wot, Wot, Wot, Wot, Wot, Wot, Wot, Wot, Wot, Wot, Wot, Wot, Wot, Wot, Wwt, Wwt, Wot, Wot, Wot, Wot, Wot, Wot, Wot, Wot, Wot, Wot, Wot, Wot, Wot, Wot, Wot, Wot
Wot, Wot, Wot, Wot, Wot, Wot, Wot, Wot, Wot, Wot, Wot, Wot, Wot, Wot, Wot, Wot, Wwt, Wot, Wot, Wot, Wot, Wot, Wot, Wot, Wot, Wot, Wot, Wot, Wot, Wot, Wot, Wwt, Wwt, Wot, Wot, Wot, Wot, Wot, Wot, Wot, Wot, Wot, Wot, Wot, Wot, Wot, Wot
Wot, Wot, Wot, Wot, Wot, Wot, Wot, Wot, Wot, Wot, Wot, Wot, Wot, Wot, Wot, Wot, Wwt, Wot, Wwt, Wot, Wot, Wot, Wot, Wot, Wot, Wot, Wot, Wot, Wot, Wot, Wot, Wot, Wot, Wwt, Wwt, Wot, Wot, Wot, Wot, Wot, Wot, Wot, Wot, Wot, Wot, Wot, Wot
Wot, Wot, Wot, Wot, Wot, Wot, Wot, Wot, Wot, Wot, Wot, Wot, Wot, Wot, Wwt, Wwt, Wwt, Wwt, Wwt, Wwt, Wwt, Wot, Wot, Wot, Wot, Wot, Wot, Wot, Wot, Wot, Wot, Wot, Wot, Wot, Wot, Wwt, Wot, Wot, Wot, Wot, Wot, Wot, Wot, Wot, Wot, Wot, Wot
Wot, Wot, Wot, Wot, Wot, Wot, Wot, Wot, Wot, Wot, Wot, Wot, Wwt, Wwt, Ds, Ds, Rrd, Rrd, Rrd, Rrd, Rrd, Wwt, Wot, Wot, Wot, Wot, Wot, Wot, Wot, Wot, Wot, Wot, Wot, Wot, Wot, Wot, Wot, Wot, Wot, Wot, Wot, Wot, Wot, Wot, Wot, Wot, Wot
Wot, Wot, Wot, Wot, Wot, Wot, Wot, Wot, Wot, Wot, Wot, Wot, Wwt, Wwt, Rrd, Dd^Dc, Hd, Hd, Hd, Dd^Dc, Rrd, Wwt, Wot, Wot, Wot, Wot, Wot, Wot, Wot, Wot, Wot, Wot, Wot, Wot, Wot, Wot, Wot, Wot, Wot, Wot, Wot, Wot, Wot, Wot, Wot, Wot, Wot
Wot, Wot, Wot, Wot, Wot, Wot, Wot, Wot, Wot, Wot, Wot, Wwt, Wwr, Rrd, Rrd^Dr, Ds, Rrd, Hd, Wwt, Rrd, Cm, Wwt, Wot, Wot, Wot, Wot, Wot, Wot, Wot, Wot, Wot, Wot, Wot, Wot, Wot, Wot, Wot, Wot, Wot, Wot, Wot, Wot, Wot, Wot, Wot, Wot, Wot
Wot, Wot, Wot, Wot, Wot, Wot, Wot, Wot, Wot, Wot, Wwt, Wwt, Wwr, Cm, Wwt, Ww^Vm, Wwt, Wwt, Wot, Wwt, Wwt, Wwt, Wot, Wot, Wwt, Wot, Wot, Wot, Wot, Wot, Wot, Wot, Wot, Wot, Wot, Wot, Wot, Wot, Wot, Wot, Wot, Wot, Wot, Wot, Wot, Wot, Wot
Wot, Wot, Wot, Wot, Wot, Wot, Wot, Wot, Wot, Wot, Wwt, Wwt, Wwr, Wwt, Wot, Wwt, Wot, Wot, Wot, Wwt, Wwt, Wwt, Wwt, Wwt, Wwt, Wwt, Wwt, Wot, Wot, Wot, Wot, Wot, Wot, Wot, Wot, Wot, Wot, Wot, Wot, Wot, Wot, Wot, Wot, Wot, Wot, Wot, Wot
Wot, Wot, Wot, Wot, Wot, Wot, Wot, Wot, Wot, Wot, Wwt, Wwr, Wwr, Wwt, Wot, Wot, Wot, Wot, Wwt, Wwt, Cm, Wwt, Ww^Vm, Wwt, Ds, Wwt, Dd^Do, Wwt, Wwt, Wot, Wot, Wot, Wot, Wot, Wot, Wot, Wot, Wot, Wot, Wot, Wot, Wot, Wot, Wot, Wot, Wot, Wot
Wot, Wot, Wot, Wot, Wot, Wot, Wot, Wot, Wot, Wot, Wwt, Wwt, Wwr, Wwt, Wot, Wot, Wwt, Wwt, Wwf, Rd, Rd, Wwf, Rd, Ds, Dd^Dc, Re^Fts, Re^Fts, Ds^Fts, Wwt, Wot, Wot, Wot, Wot, Wot, Wot, Wot, Wot, Wot, Wot, Wot, Wot, Wot, Wot, Wot, Wot, Wot, Wot
Wot, Wot, Wot, Wot, Wot, Wot, Wot, Wot, Wot, Wot, Wwt, Wwr, Rrd, Wwt, Wwt, Wwt, Cm, Rd, Rd, Wwt, Wwf, Wwt, Re, Hd, Ds, Re, Re, Ds, Wwt, Wot, Wot, Wot, Wwt, Wot, Wwt, Wwt, Wwt, Wot, Wot, Wot, Wot, Wot, Wot, Wot, Wot, Wot, Wot
Wot, Wot, Wot, Wot, Wot, Wot, Wot, Wot, Wwt, Wwr, Rrd, Rrd, Wwt, Rrd, Cm, Wwt, Wwt, Wwt, Re, Ds, Re, Re, Ds, Re, Wwf, Ds, Wwt, Cm, Wwt, Wot, Wwt, Wwt, Cm, Wwt, Wwt, Wwt, Wwt, Wwt, Wwt, Wot, Wot, Wot, Wot, Wot, Wot, Wot, Wot
Wot, Wot, Wot, Wot, Wot, Wot, Wot, Wot, Wwt, Cm, Rrd, Ds, Wwt, Rrd, Ds, Wwt, Wot, Wwt, Wwt, Re, Re, Wwt, Rb, Rb, Wwt, Wwt, Wwt, Wwt, Wwt, Wwt, Cm, Wwt, Wwt, Ds, Ds, Ds, Ds, Ww^Vm, Ds, Wwt, Wwt, Wwt, Wwt, Wot, Wot, Wot, Wot
Wot, Wot, Wot, Wot, Wot, Wot, Wot, Wot, Wwt, Rrd, Wwrt, Wwt, Wwrt, Rrd, Ww^Vm, Wwt, Wot, Wot, Wot, Wwt, Wwf, Ww^Vm, Wwt, Wwt, Wwt, Wwt, Wot, Wot, Wwt, Wwt, Ds, Wwt, Wwt, Ds, Ds, Ds, Ds, Ds, Ds, Wwt, Ds, Ds, Wwf, Wwt, Wwt, Wot, Wot
Wot, Wot, Wot, Wot, Wot, Wot, Wot, Wwt, Wwt, Rrd, Wwt, Gd, Wwt, Gd, Gd, Wwt, Wot, Wot, Wot, Wwt, Wwf, Wwt, Wot, Wot, Wot, Wot, Wot, Wot, Wwt, Ds, Ds, Wwt, Wwrt, Wwrt, Wwt, Ds, Wwt, Ds, Ds, Ds, Ds, Wwt, Ds, Ds, Wwt, Wot, Wot
Wot, Wot, Wot, Wot, Wot, Wot, Wwt, Wwt, Rrd, Rrd, Wwrt, Gd, Gd, Wwt, Gd, Wwt, Wwt, Wot, Wot, Wwt, Wwf, Wwt, Wot, Wot, Wot, Wot, Wwt, Wwt, Wwt, Wwt, Wwf, Wwrt, Wwt, Wwt, Wwrt, Ds, Ds, Ds, Ds, Ds, Ds, Dd^Do, Ds, Wwt, Wot, Wot, Wot
Wot, Wot, Wot, Wot, Wot, Wwt, Wwt, Wwt, Rrd, Rrd, Wwt, Gd, Gd, Wwt, Gd, Ds^Ewsh, Wwt, Wot, Wwt, Wwt, Rd, Wwt, Wwt, Wot, Wwt, Wwt, Wwt, Wwrt, Wwt, Wwrt, Wwt, Wwf, Ds, Ds, Wwrt, Wwt, Wwt, Ds, Ww^Vm, Ds, Wwt, Ds, Cm, Wwt, Wot, Wot, Wot
Wot, Wot, Wot, Wot, Wot, Wwt, Wwt, Wwt, Rrd, Wot, Ww^Vm, Gd, Gd, Wwt, Gd, Wwt, Wwt, Wot, Wwt, Cm, Km, Wwf, Wwt, Wwt, Wwt, Wwrt, Ds, Ds, Ds, Wwrt, Wwt, Wwt, Wwt, Ds, Wwt, Wwt, Wwt, Wwt, Wwt, Wwt, Wot, Wwt, Wwt, Wwt, Wot, Wot, Wot
Wot, Wot, Wot, Wot, Wot, Wwt, Wwt, Rrd, Rrd, Wwt, Gd, Gs^Ft, Hhd, Wwt, Hhd, Gd, Wwrt, Wot, Wwt, Cm, Wwt, Wwf, Cm, Wwrt, Ds, Ds, Ds, Wwt, Wwt, Wwrt, Wwrt, Wwt, Wwt, Wwt, Wot, Wot, Wot, Wot, Wot, Wot, Wwt, Wwt, Cm, Wwt, Wot, Wot, Wot
Wot, Wot, Wot, Wot, Wot, Wwt, Wwt, Rrd, Rrd, Wwt, Gd, Gd, Hhd, Hhd, Wwf, Wwf, Wwrt, Wot, Wot, Wwt, Wwt, Wwt, Wwt, Ds, Ds, Ds, Ds, Wwt, Wwt, Wwt, Wwt, Wwrt, Wwt, Wwt, Wot, Wot, Wot, Wot, Wot, Wot, Wwt, Rb, Rb, Wwt, Wwt, Wot, Wot
Wot, Wot, Wot, Wot, Wot, Wwt, Wwt, Rrd, Rrd, Wwt, Wwt, Gd, Gd, Hhd, Wwt, Gd, Wwt, Wot, Wot, Wot, Wwt, Wwt, Wwrt, Wwrt, Wwf, Wwt, Wwt, Wwf, Ww, Wwt, Wwf, Ds, Ds, Wwt, Wot, Wot, Wot, Wot, Wwt, Wwt, Gs, Gs, Rb, Wwt, Wwt, Wot, Wot
Wot, Wot, Wwt, Wot, Wot, Wwt, Wwt, Wwrt, Rrd, Wwt, Wwt, Gd, Ww^Vm, Wwt, Wot, Gd, Ds, Wwt, Wwt, Wot, Cm, Wwrt, Wwrt, Wwt, Wwf, Ww^Vm, Cm, Wwt, Wwf, Wwf, Wwrt, Ds, Ds, Wwt, Wwt, Wot, Wot, Wot, Wwt, Ww^Vm, Gd, Gd, Gd, Wwt, Wwt, Wot, Wot
Wot, Wwt, Rd, Wwt, Wwt, Wot, Wwt, Wwt, Wwt, Rrd, Wwrt, Wwt, Wot, Wot, Wwt, Wwt, Gd, Wwt, Wwt, Wwrt, Ds, Wwrt, Wwf, Wwf, Cm, Cm, Cm, Wwf, Wwf, Wwt, Ww^Vm, Ds, Ds, Ds, Wwt, Wot, Wot, Wot, Wwt, Gd, Gd, Gd, Re, Re, Wwt, Wwt, Wot
Wot, Wwt, Hhd, Rd, Wwt, Wot, Wot, Wwt, Wwt, Wwt, Rd, Wwt, Wot, Wot, Ww^Vm, Rb, Rb, Wwrt, Wwt, Wwt, Ds, Ds, Ww^Vm, Wwt, Cm, Km, Cm, Wwt, Wwf, Wwt, Ds, Ds, Ds, Wwt, Wot, Wot, Wot, Wot, Re, Re, Wwt, Wwt, Wwrt, Rb, Wwt, Wot, Wot
Wot, Wwt, Wwt, Rd, Wwt, Wwt, Wot, Wwt, Wwt, Wwt, Rd, Wwt, Wwt, Wot, Wwt, Rb, Wwt, Wwrt, Wwrt, Ds, Wwt, Ds, Ds, Wwt, Cm, Cm, Wwf, Wwt, Wwt, Wwf, Ds, Ds, Wwt, Wwt, Wot, Wot, Wwt, Wwt, Wwt, Wwt, Wwt, Wwt, Rb, Rb, Wwt, Wot, Wot
Wot, Wot, Wwt, Wwf, Wwt, Wot, Wwt, Wot, Wot, Wwt, Wwrt, Ds, Wwf, Wwt, Rb, Rb, Wwt, Wwt, Ds, Ds, Wwt, Wwt, Ds, Wwf, Wwf, Wwt, Wwf, Wwt, Ww, Wwrt, Wwrt, Cm, Wwt, Wot, Wot, Wwt, Rb, Rb, Wwt, Ww^Vm, Wwt, Wwt, Rb, Wwrt, Wot, Wot, Wot
Wot, Wot, Wwt, Wwf, Wwt, Wwt, Wwt, Wwt, Wot, Wot, Wwt, Wwrt, Wwrt, Rb, Wwrt, Wwrt, Wwt, Wwt, Ds, Wwt, Wwt, Wwt, Ds, Wwt, Ww, Wwf, Wwt, Wwt, Wwrt, Wwt, Wwrt, Wwt, Wot, Wot, Wot, Wwt, Rb, Rb, Wwt, Wwt, Re, Re, Wwt, Wwt, Wot, Wot, Wot
Wot, Wwt, Rd, Gs, Gg, Gg, Wwt, Wwt, Wwt, Wot, Wwt, Wwt, Wwt, Wwt, Wot, Wwrt, Wwt, Wwt, Ds, Wwt, Wwt, Wwt, Ds, Wwt, Wwt, Wwf, Ds, Wwrt, Ds, Wwrt, Wwt, Wot, Wot, Wot, Wot, Wwt, Wwt, Rb, Rb, Re, Wwt, Wwt, Wot, Wot, Wot, Wot, Wot
Wot, Wwt, Gd, Hh, Gg, Ww^Vm, Wwt, Wwt, Wwt, Wot, Wot, Wwt, Wot, Wot, Wot, Wot, Wot, Wwt, Ds, Wwt, Ds, Ds, Ds, Wwt, Wwrt, Wwrt, Ds, Ds, Wwt, Cm, Wwt, Wot, Wot, Wot, Wot, Wwt, Wwt, Rb, Wwrt, Wwt, Wot, Wot, Wot, Wot, Wot, Wot, Wot
Wot, Wwt, Gd, Hh, Hh, Gg, Wwt, Wwt, Wwt, Wot, Wot, Wot, Wot, Wot, Wot, Wot, Wot, Wwt, Wwrt, Ds, Wwt, Ds, Wwt, Wwrt, Wwt, Ds, Wwt, Wwt, Wwt, Wwt, Wot, Wot, Wot, Wot, Wwt, Wwt, Wwt, Wwf, Wwrt, Wwt, Wwt, Wot, Wwt, Wot, Wwt, Wot, Wot
Wot, Wwt, Wwt, Gd, Rd, Wwt, Wot, Wot, Wot, Wot, Wot, Wot, Wot, Wot, Wot, Wot, Wot, Wwt, Wwrt, Wwt, Wwt, Wwt, Wwt, Wwt, Wwt, Wwt, Wwt, Wwt, Wot, Wot, Wot, Wot, Wot, Wot, Wwt, Wwt, Wwt, Rb, Rb, Wwt, Rb, Wwt, Gg, Wwt, Wwt, Wot, Wot
Wot, Wot, Wot, Wwt, Wwt, Wwt, Wot, Wot, Wot, Wot, Wot, Wot, Wot, Wot, Wot, Wot, Wot, Wwt, Wwt, Wwrt, Rb, Wwt, Wwt, Wwt, Ww^Vm, Wwt, Wot, Wot, Wot, Wot, Wwt, Wwt, Wwt, Wwt, Wwt, Wwt, Wwt, Gd, Gg, Rb, Gll^Ftr, Gll^Ftr, Gg, Rb, Wot, Wot, Wot
Wot, Wot, Wot, Wot, Wot, Wot, Wot, Wot, Wot, Wot, Wot, Wot, Wot, Wot, Wot, Wot, Wot, Wwt, Wwt, Rb, Ds, Rb, Rd, Rd, Rd, Wwt, Wot, Wot, Wwt, Wwt, Rd, Wwt, Cm, Wwt, Wwt, Wwt, Gg, Gg, Gll^Ftr, Gll^Ftr, Hh, Hh, Wwrt, Wwt, Wot, Wot, Wot
Wot, Wot, Wot, Wot, Wot, Wot, Wot, Wot, Wot, Wot, Wot, Wot, Wot, Wot, Wot, Wot, Wot, Wot, Wot, Wwt, Ds, Ds, Wwt, Ds, Ds, Wwt, Wwt, Wwt, Wwt, Ww^Vm, Rd, Rd, Km, Wwt, Wwt, Gg, Gll^Ftr, Gll^Ftr, Hh^Ftr, Hh^Ftr, Mm, Hh, Gg, Wwt, Wot, Wot, Wot
Wot, Wot, Wot, Wot, Wot, Wot, Wot, Wot, Wot, Wot, Wot, Wot, Wot, Wot, Wot, Wot, Wot, Wot, Wot, Wwt, Wwrt, Ds, Ds, Ds, Cm, Wwt, Wwt, Wwt, Rd, Rd, Wwt, Re, Re, Wwt, Wwt, Gg, Gg, Hh, Hh, Hh, Hh, Hh, Rb, Wwt, Wot, Wot, Wot
Wot, Wot, Wot, Wot, Wot, Wot, Wot, Wot, Wot, Wot, Wot, Wot, Wot, Wot, Wot, Wot, Wot, Wot, Wot, Wwt, Wwrt, Ds^Ewsh, Wwt, Wwt, Wwt, Wot, Cm, Rd, Wwt, Wwt, Wot, Wwt, Rb, Wwt, Wwf, Wwf, Gg, Hh, Gg, Hh, Wwrt, Gd, Wwt, Wwt, Wot, Wot, Wot
Wot, Wot, Wot, Wot, Wot, Wot, Wot, Wwt, Wot, Wot, Wot, Wot, Wot, Wot, Wot, Wot, Wot, Wot, Wot, Wot, Wwt, Wwrt, Wot, Wot, Wot, Wwt, Rb, Rd, Wwt, Wwt, Ww^Vm, Wwt, Rb, Wwf, Wwt, Wwt, Gll^Ftr, Gll^Ftr, Gg, Rb, Wwt, Wwt, Wot, Wot, Wot, Wot, Wot
Wot, Wot, Wot, Wot, Wot, Wot, Wot, Wot, Wot, Wot, Wot, Wot, Wot, Wot, Wot, Wot, Wot, Wot, Wot, Wot, Wot, Wot, Wot, Wot, Wot, Wwt, Wwt, Rb, Wwt, Rb, Rb, Rb, Rb, Rb, Wwt, Wwt, Gll^Ftr, Gll^Ftr, Wwt, Wwt, Wot, Wot, Wot, Wot, Wot, Wot, Wot
Wot, Wot, Wot, Wot, Wot, Wot, Wot, Wot, Wot, Wot, Wot, Wot, Wot, Wot, Wot, Wot, Wot, Wot, Wot, Wot, Wot, Wot, Wot, Wot, Wot, Wot, Wot, Wwt, Wwt, Wwt, Wwt, Wwt, Wwt, Wwt, Wot, Wwt, Wwt, Wwt, Wot, Wot, Wot, Wot, Wot, Wot, Wot, Wot, Wot
Wot, Wot, Wot, Wot, Wot, Wot, Wot, Wot, Wot, Wot, Wot, Wot, Wot, Wot, Wot, Wot, Wot, Wot, Wot, Wot, Wot, Wot, Wot, Wot, Wot, Wot, Wot, Wot, Wot, Wot, Wot, Wot, Wot, Wot, Wot, Wot, Wot, Wot, Wot, Wot, Wot, Wot, Wot, Wot, Wot, Wot, Wot
Wot, Wot, Wot, Wot, Wot, Wot, Wot, Wot, Wot, Wot, Wot, Wot, Wot, Wot, Wot, Wot, Wot, Wot, Wot, Wot, Wot, Wot, Wot, Wot, Wot, Wot, Wot, Wot, Wot, Wot, Wot, Wot, Wot, Wot, Wot, Wot, Wot, Wot, Wot, Wot, Wot, Wot, Wot, Wot, Wot, Wot, Wot
Wot, Wot, Wot, Wot, Wot, Wot, Wot, Wot, Wot, Wot, Wot, Wot, Wot, Wot, Wot, Wot, Wot, Wot, Wot, Wot, Wot, Wot, Wot, Wot, Wot, Wot, Wot, Wot, Wot, Wot, Wot, Wot, Wot, Wot, Wot, Wot, Wot, Wot, Wot, Wot, Wot, Wot, Wot, Wot, Wot, Wot, Wot
Wot, Wot, Wot, Wot, Wot, Wot, Wot, Wot, Wot, Wot, Wot, Wot, Wot, Wot, Wot, Wot, Wot, Wot, Wot, Wot, Wot, Wot, Wot, Wot, Wot, Wot, Wot, Wot, Wot, Wot, Wot, Wot, Wot, Wot, Wot, Wot, Wot, Wot, Wot, Wot, Wot, Wot, Wot, Wot, Wot, Wot, Wot
Wot, Wot, Wot, Wot, Wot, Wot, Wot, Wot, Wot, Wot, Wot, Wot, Wot, Wot, Wot, Wot, Wot, Wot, Wot, Wot, Wot, Wot, Wot, Wot, Wot, Wot, Wot, Wot, Wot, Wot, Wot, Wot, Wot, Wot, Wot, Wot, Wot, Wot, Wot, Wot, Wot, Wot, Wot, Wot, Wot, Wot, Wot
