Wot, Wot, Wot, Wot, Wot, Wot, Wot, Wot, Wot, Wot, Wot, Wot, Wot, Wot, Wot, Wot, Wot, Wot, Wot, Wot, Wot, Wot, Wot, Wot, Wot, Wot, Wot, Wot, Wwt, Wot, Wot, Wot, Wot, Wot, Wot, Wot, Wot, Wot, Wot, Wot, Wot, Wot, Wot, Wot, Wot, Wot, Wot
Wot, Wot, Wot, Wot, Wot, Wot, Wot, Wot, Wot, Wot, Wot, Wot, Wot, Wot, Wot, Wot, Wot, Wot, Wot, Wot, Wot, Wot, Wot, Wot, Wot, Wot, Wwt, Wwt, Rb, Wwt, Wwt, Wot, Wot, Wot, Wot, Wot, Wot, Wot, Wot, Wot, Wot, Wot, Wot, Wot, Wot, Wot, Wot
Wot, Wot, Wot, Wot, Wot, Wot, Wot, Wot, Wot, Wot, Wot, Wot, Wot, Wot, Wot, Wot, Wot, Wot, Wot, Wot, Wot, Wot, Wwt, Wwt, Rb, Wwt, Wwrt, Gg, Hh, Gd, Wwrt, Wwt, Wwt, Wot, Wot, Wot, Wot, Wot, Wot, Wot, Wot, Wot, Wot, Wot, Wot, Wot, Wot
Wot, Wot, Wot, Wot, Wot, Wot, Wot, Wot, Wot, Wot, Wot, Wot, Wot, Wot, Wot, Wot, Wot, Wot, Wot, Wot, Wot, Wot, Wot, Wwt, Gg, Gg, Hh, Hh, Mm, Hh, Hh, Rb, Gg, Wwt, Wwt, Wot, Wot, Wot, Wot, Wot, Wot, Wot, Wot, Wot, Wot, Wot, Wot
Wot, Wot, Wot, Wot, Wot, Wot, Wot, Wot, Wot, Wot, Wot, Wot, Wot, Wot, Wot, Wot, Wot, Wot, Wot, Wot, Wot, Wot, Wot, Wwt, Wwt, Gll^Ftr, Gll^Ftr, Hh, Hh^Ftr, Hh, Hh, Gg, Gll^Ftr, Gll^Ftr, Gll^Ftr, Wwt, Wot, Wot, Wot, Wot, Wot, Wot, Wot, Wot, Wot, Wot, Wot
Wot, Wot, Wot, Wot, Wot, Wot, Wot, Wot, Wot, Wot, Wot, Wot, Wot, Wot, Wwt, Wot, Wwt, Wwt, Wwrt, Wwt, Wwt, Wot, Wot, Wot, Wwt, Rb, Rb, Gll^Ftr, Gll^Ftr, Hh^Ftr, Hh, Hh, Gg, Gll^Ftr, Wwt, Wwt, Wot, Wot, Wot, Wot, Wot, Wot, Wot, Wot, Wot, Wot, Wot
Wot, Wot, Wot, Wot, Wot, Wot, Wot, Wot, Wot, Wot, Wot, Wot, Wot, Wot, Wwt, Wwt, Rb, Rb, Rb, Rb, Re, Wwt, Wwt, Wot, Wwt, Wwt, Rb, Gg, Gg, Gll^Ftr, Gll^Ftr, Gg, Wwf, Wwt, Wwt, Wwt, Wwt, Wot, Wot, Wot, Wot, Wot, Wot, Wot, Wot, Wot, Wot
Wot, Wot, Wot, Wot, Wot, Wot, Wot, Wot, Wot, Wot, Wot, Wot, Wwt, Wwt, Wwt, Re, Re, Wwrt, Wwt, Wwt, Wwt, Re, Re, Wwt, Wwrt, Wwrt, Rb, Gd, Wwt, Gg, Gg, Gg, Wwt, Wwf, Wwf, Rb, Rb, Wwt, Wot, Wot, Wot, Wot, Wot, Wot, Wot, Wot, Wot
Wot, Wot, Wot, Wot, Wot, Wot, Wot, Wot, Wot, Wot, Wot, Wot, Wwt, Wwt, Rb, Gd, Gd, Wwt, Wwt, Wwt, Ww^Vm, Wwt, Wwt, Rb, Rb, Wwf, Wwt, Wwt, Wwt, Wwt, Wwt, Wwt, Wwt, Wwt, Rb, Rb, Rb, Wwt, Wwt, Wot, Wot, Wot, Wot, Wot, Wot, Wot, Wot
Wot, Wot, Wot, Wot, Wot, Wot, Wot, Wot, Wot, Wot, Wwt, Wwt, Cm, Rb, Gs, Gd, Gd, Gd, Re, Wwt, Wwt, Wwt, Rb, Rb, Wwt, Wwt, Wwt, Wwt, Wwt, Wwt, Wwt, Wwt, Km, Re, Wwt, Wwt, Ww^Vm, Rb, Wwt, Wot, Wot, Wot, Wot, Wot, Wot, Wot, Wot
Wot, Wot, Wot, Wot, Wot, Wot, Wwt, Wwt, Wwt, Wwt, Cm, Wwt, Wwt, Rb, Wwt, Gs, Ww^Vm, Gd, Wwt, Re, Wwt, Rb, Rb, Rb, Wwt, Wwt, Wot, Wwt, Wot, Wwt, Wwt, Cm, Rd, Re, Wwt, Wot, Wwt, Rb, Wwt, Wwt, Wot, Wot, Wot, Wot, Wot, Wot, Wot
Wot, Wot, Wot, Wot, Wot, Wot, Wwt, Ds, Ds, Ds, Ds, Wwt, Wot, Wwt, Wot, Wwt, Wwt, Wwt, Wot, Wot, Wot, Wwt, Wwt, Wwt, Wot, Wot, Wot, Wot, Wot, Wot, Wwt, Wwt, Rd, Rd, Rd, Wwt, Wwt, Wwt, Rb, Wwt, Wot, Wot, Wot, Wot, Wot, Wot, Wot
Wot, Wot, Wot, Wot, Wot, Wot, Wwt, Wwf, Wwt, Dd^Do, Ds, Wwt, Wwt, Wot, Wot, Wot, Wot, Wot, Wot, Wot, Wot, Wot, Wot, Wot, Wot, Wot, Wot, Wot, Wot, Wot, Wot, Wwt, Wwt, Ww^Vm, Wwt, Rd, Rd, Rd, Rb, Wwt, Wot, Wot, Wot, Wot, Wot, Wot, Wot
Wot, Wot, Wot, Wot, Wot, Wot, Wwt, Ds, Ds, Ds, Ds, Ds, Ww^Vm, Wwt, Wot, Wot, Wot, Wot, Wot, Wot, Wwt, Wot, Wwt, Wot, Wwt, Wot, Wot, Wot, Wwt, Wot, Wot, Wot, Wot, Wwt, Wwt, Wwt, Wwt, Cm, Wwt, Wwt, Wot, Wot, Wot, Wot, Wot, Wot, Wot
Wot, Wot, Wot, Wot, Wot, Wot, Wot, Wwt, Wwt, Ds, Ds, Ds, Ds, Wwt, Wwt, Wot, Wot, Wot, Wot, Wwt, Ds, Wwt, Ds, Wwt, Cm, Wwt, Wwrt, Wwt, Cm, Wwt, Wwt, Wot, Wot, Wot, Wot, Wwt, Wwt, Wot, Wwt, Wot, Wot, Wot, Wot, Wot, Wot, Wot, Wot
Wot, Wot, Wot, Wot, Wot, Wot, Wot, Wwt, Ds, Ds, Ds, Ds, Ds, Wwt, Wwt, Wot, Wot, Wot, Wwt, Wwt, Ds, Ds, Ds, Ds, Ds, Wwrt, Wwt, Wwrt, Ds, Wwt, Wwt, Wwt, Wwt, Wot, Wwt, Wwt, Ds, Cm, Wwt, Wot, Wot, Wot, Wot, Wot, Wot, Wot, Wot
Wot, Wot, Wot, Wot, Wot, Wot, Wot, Wwt, Ww^Vm, Ds, Ds, Wwt, Ds, Wwt, Wwrt, Wwt, Wwt, Wwt, Wwt, Ds, Ds, Ds, Ww^Vm, Ds, Wwf, Wwrt, Ww, Wwrt, Wwrt, Ds, Ds, Wwt, Wwt, Wwt, Ww^Vm, Rd, Ds, Ds, Ds, Wwt, Wwrt, Wot, Wot, Wot, Wot, Wot, Wot
Wot, Wot, Wot, Wot, Wot, Wot, Wot, Wwt, Wwt, Ds, Ds, Ds, Wwt, Wwrt, Ds, Ds, Wwt, Wwt, Wwrt, Ds, Wwf, Wwrt, Wwt, Wwt, Wwf, Wwt, Wwt, Wwt, Wwt, Ds, Wwrt, Ds, Wwt, Wwt, Wwt, Rd, Rd, Wwt, Ds, Ds^Ewsh, Wwrt, Wwt, Wot, Wot, Wot, Wot, Wot
Wot, Wot, Wot, Wot, Wot, Wot, Wot, Wwt, Wwt, Ds, Ds, Ds, Wwrt, Wwt, Wwt, Ds, Wwt, Wwt, Wwrt, Wwt, Wwt, Wwf, Wwf, Wwf, Wwt, Wwt, Wwf, Wwf, Wwf, Wwf, Wwt, Wwrt, Wwrt, Wwt, Wwt, Wwt, Rb, Ds, Ds, Wwrt, Wwt, Wot, Wot, Wot, Wot, Wot, Wot
Wot, Wot, Wot, Wot, Wot, Wot, Wot, Wwt, Wwt, Wwt, Ds, Ds, Wwt, Wwrt, Wwrt, Wwf, Wwt, Wwt, Wwrt, Wwt, Wwt, Ww, Wwt, Wwf, Cm, Cm, Cm, Wwt, Wwf, Ww, Wwt, Wwt, Ds, Wwt, Wwt, Wwt, Rb, Ds, Wwt, Wwt, Wot, Wot, Wot, Wot, Wot, Wot, Wot
Wot, Wot, Wot, Wot, Wot, Wot, Wot, Wot, Wot, Wwt, Cm, Wwt, Wwt, Wwt, Ds, Wwf, Wwrt, Wwrt, Ds, Wwt, Wwt, Wwf, Wwt, Cm, Cm, Km, Cm, Cm, Wwf, Wwt, Ds, Ds, Ds, Ds, Wwt, Wwt, Wwrt, Rb, Wwt, Wot, Wot, Wot, Wot, Wot, Wot, Wot, Wot
Wot, Wot, Wot, Wot, Wot, Wot, Wot, Wot, Wot, Wwt, Wwt, Wwt, Cm, Ds, Ds, Wwt, Wwt, Wwt, Ds, Wwt, Ds, Ds, Wwt, Ww^Vm, Wwf, Cm, Wwt, Wwt, Ds, Ds, Wwt, Wwt, Wwt, Ds, Ds, Wwt, Wwrt, Wwt, Wwt, Wot, Wot, Wot, Wot, Wot, Wot, Wot, Wot
Wot, Wot, Wot, Wot, Wot, Wot, Wot, Wot, Wot, Wot, Wot, Wwt, Wwt, Wwt, Wwt, Wwt, Wwt, Wwrt, Wwt, Ds, Ds, Ds, Ds, Wwf, Wwt, Wwf, Wwf, Ww^Vm, Ds, Wwt, Wwt, Wwt, Wwt, Wwt, Ds, Wwrt, Wwt, Wwt, Wot, Wot, Wot, Wot, Wot, Wot, Wot, Wot, Wot
Wot, Wot, Wot, Wot, Wot, Wot, Wot, Wot, Wot, Wot, Wot, Wot, Wwt, Wwt, Wot, Wot, Wot, Wwt, Wwt, Wwrt, Wwt, Ds, Ds, Wwrt, Wwrt, Wwrt, Wwrt, Ds, Ds, Wwt, Ds, Wwt, Ds, Ds, Wwt, Wwt, Wot, Wot, Wot, Wot, Wot, Wot, Wot, Wot, Wot, Wot, Wot
Wot, Wot, Wot, Wot, Wot, Wot, Wot, Wot, Wot, Wot, Wwt, Wwt, Cm, Wwt, Wwt, Wot, Wot, Wot, Wot, Wwt, Wwt, Wwrt, Cm, Wwt, Wwt, Wwrt, Cm, Ds, Wwt, Ds, Wwrt, Ds, Wwt, Wwt, Wwt, Wot, Wot, Wot, Wot, Wot, Wot, Wot, Wot, Wot, Wot, Wot, Wot
Wot, Wot, Wot, Wot, Wot, Wot, Wot, Wot, Wot, Wwt, Ds^Fts, Ds, Re, Wwt, Wwt, Wwt, Wwt, Wot, Wot, Wot, Wwt, Wwt, Wwf, Wwt, Wwt, Wwt, Wot, Wwrt, Wwt, Wwt, Wwrt, Wwt, Wwt, Wwt, Wwrt, Wot, Wot, Wot, Wot, Wot, Wot, Wot, Wot, Wot, Wot, Wot, Wot
Wot, Wot, Wot, Wot, Wot, Wot, Wot, Wot, Wot, Wwt, Dd^Do, Re^Fts, Re, Ds, Wwf, Wwt, Wwt, Wot, Wot, Wot, Wwt, Wwf, Km, Wwt, Wwt, Wot, Wot, Wwt, Wwt, Wwrt, Rb, Wwt, Rb, Wwrt, Wwrt, Wot, Wot, Wot, Wot, Wot, Wot, Wot, Wot, Wot, Wot, Wot, Wot
Wot, Wot, Wot, Wot, Wot, Wot, Wot, Wot, Wot, Wwt, Wwt, Re^Fts, Dd^Dc, Ds, Re, Rb, Rb, Wwt, Wwt, Wwt, Wwf, Rd, Cm, Cm, Wwt, Wot, Wot, Wwt, Ds, Gd, Rb, Rb, Wwt, Rb, Rb, Wwt, Wwt, Wot, Wot, Wot, Wot, Wot, Wot, Wot, Wot, Wot, Wot
Wot, Wot, Wot, Wot, Wot, Wot, Wot, Wot, Wot, Wwt, Wwt, Ds, Ds, Hd, Re, Ds, Wwt, Ww^Vm, Wwf, Wwf, Wwt, Wwt, Wwt, Wwt, Wot, Wot, Wwrt, Wwt, Gd, Wwt, Wwt, Ww^Vm, Wot, Wwt, Wwf, Wwrt, Wwt, Wwt, Wot, Wot, Wot, Wot, Wot, Wot, Wot, Wot, Wot
Wot, Wot, Wot, Wot, Wot, Wot, Wot, Wot, Wot, Wwt, Wwt, Wwt, Ww^Vm, Rd, Wwt, Re, Re, Re, Wwt, Wwt, Wot, Wot, Wot, Wot, Wwt, Wwrt, Wwf, Gd, Wwt, Wot, Wot, Wot, Wot, Wwt, Ds, Wwrt, Wwt, Wwt, Wot, Wot, Wwt, Wot, Wot, Wot, Wot, Wot, Wot
Wot, Wot, Wot, Wot, Wot, Wot, Wot, Wot, Wot, Wot, Wot, Wwt, Wwt, Wwf, Rd, Wwf, Ds, Re, Wwt, Wot, Wot, Wot, Wwt, Wwt, Wwt, Gd, Hhd, Wwf, Hhd, Wwt, Ww^Vm, Wot, Wwt, Wwt, Rd, Wwrt, Wot, Wot, Wwt, Wwt, Wwt, Wot, Wot, Wot, Wot, Wot, Wot
Wot, Wot, Wot, Wot, Wot, Wot, Wot, Wot, Wot, Wot, Wwt, Wwt, Wwt, Cm, Rd, Wwt, Rd, Re, Wwt, Wot, Wot, Wot, Wwt, Ds^Ewsh, Gd, Gd, Wwt, Hhd, Hhd, Gd, Gd, Wwt, Wwrt, Rd, Wwt, Wwt, Wot, Wot, Wwt, Wwt, Wwt, Wwt, Wwt, Wwt, Wwt, Wot, Wot
Wot, Wot, Wot, Wot, Wot, Wot, Wot, Wot, Wwt, Wwt, Cm, Wwt, Wwt, Wwt, Wwt, Wwf, Rd, Wwt, Wwt, Wot, Wwt, Wwt, Gd, Gd, Wwt, Wwt, Gd, Hhd, Gd, Gd, Wwt, Wwt, Rd, Wwt, Wwt, Wwt, Wot, Wwt, Wwt, Wwt, Ww^Vm, Gg, Hh, Rd, Wwt, Wot, Wot
Wot, Wot, Wot, Wot, Wot, Wot, Wot, Wwt, Rrd, Rrd, Rrd, Wwt, Wot, Wot, Wot, Wwt, Wwt, Cm, Wwt, Wwt, Ds, Ww^Vm, Gd, Wwt, Gd, Gd, Gd, Gs^Ft, Gd, Gd, Wwt, Wwt, Rd, Wwt, Wwt, Wwt, Wot, Wwt, Wwt, Gg, Gg, Gg, Hh, Gd, Wwt, Wot, Wot
Wot, Wot, Wot, Wot, Wot, Wot, Wot, Wwt, Rrd, Dd^Dc, Hd, Wwt, Wwt, Wot, Wot, Wot, Wot, Wwt, Wwt, Cm, Rd, Rd, Wwrt, Wwt, Gd, Gd, Wwt, Ww^Vm, Wwt, Wwt, Rd, Rd, Wwrt, Wwt, Wwt, Wot, Wwt, Wot, Wwt, Wwt, Gs, Hh, Gd, Gd, Wwt, Wot, Wot
Wot, Wot, Wot, Wot, Wot, Wot, Wot, Wwt, Wwt, Rrd, Hd, Hd, Rrd, Wwt, Wwt, Wot, Wot, Wot, Wwt, Rd, Wwt, Wwt, Wwt, Gd, Wwt, Wwrt, Rd, Wot, Rd, Rd, Rd, Rd, Wwt, Wwt, Wot, Wot, Wwt, Wwt, Wwf, Wwf, Wwt, Rd, Wwt, Wwt, Wot, Wot, Wot
Wot, Wot, Wot, Wot, Wot, Wot, Wot, Wwt, Wwt, Rrd, Rrd, Hd, Ds, Ww^Vm, Wwt, Wot, Wwt, Wwt, Wwr, Rd, Rd, Ds, Rd, Wwrt, Rd, Rd, Rd, Rd, Wwt, Rd, Wwt, Wwt, Wwt, Wwt, Wot, Wwt, Rd, Rd, Wwt, Wwt, Wot, Wwt, Wot, Wot, Wot, Wot, Wot
Wot, Wot, Wot, Wot, Wot, Wot, Wot, Wot, Wwt, Wwt, Ds, Dd^Dc, Rrd, Rrd^Dr, Cm, Wwt, Wwr, Wwr, Wwt, Wwr, Wwt, Rd, Cm, Rd, Wwt, Wwt, Wwt, Wwt, Wwt, Wwt, Wwt, Wwt, Wot, Wot, Wot, Wwt, Rd, Hhd, Wwt, Wot, Wot, Wot, Wot, Wot, Wot, Wot, Wot
Wot, Wot, Wot, Wot, Wot, Wot, Wot, Wwt, Wot, Wwt, Wwt, Ds, Wwt, Rrd, Wwr, Wwr, Wwt, Wwr, Wwt, Wwt, Wot, Wwr, Wwt, Wwt, Wot, Wwt, Wot, Wwt, Wwt, Wwt, Wot, Wot, Wot, Wot, Wot, Wwt, Wwt, Wwt, Wot, Wot, Wot, Wot, Wot, Wot, Wot, Wot, Wot
Wot, Wot, Wot, Wot, Wot, Wot, Wot, Wot, Wot, Wot, Wot, Wwt, Wwt, Wwt, Wwt, Wwt, Wwt, Wwt, Wot, Wot, Wot, Wot, Wot, Wot, Wot, Wot, Wot, Wot, Wot, Wot, Wot, Wot, Wot, Wot, Wot, Wot, Wot, Wot, Wot, Wot, Wot, Wot, Wot, Wot, Wot, Wot, Wot
Wot, Wot, Wot, Wot, Wot, Wot, Wot, Wot, Wot, Wot, Wot, Wot, Wot, Wot, Wot, Wot, Wot, Wot, Wot, Wot, Wot, Wot, Wot, Wot, Wot, Wot, Wot, Wot, Wot, Wot, Wot, Wot, Wot, Wot, Wot, Wot, Wot, Wot, Wot, Wot, Wot, Wot, Wot, Wot, Wot, Wot, Wot
Wot, Wot, Wot, Wot, Wot, Wot, Wot, Wot, Wot, Wot, Wot, Wot, Wot, Wot, Wot, Wot, Wot, Wot, Wot, Wot, Wot, Wot, Wot, Wot, Wot, Wot, Wot, Wot, Wot, Wot, Wot, Wot, Wot, Wot, Wot, Wot, Wot, Wot, Wot, Wot, Wot, Wot, Wot, Wot, Wot, Wot, Wot
Wot, Wot, Wot, Wot, Wot, Wot, Wot, Wot, Wot, Wot, Wot, Wot, Wot, Wot, Wot, Wot, Wot, Wot, Wot, Wot, Wot, Wot, Wot, Wot, Wot, Wot, Wot, Wot, Wot, Wot, Wot, Wot, Wot, Wot, Wot, Wot, Wot, Wot, Wot, Wot, Wot, Wot, Wot, Wot, Wot, Wot, Wot
Wot, Wot, Wot, Wot, Wot, Wot, Wot, Wot, Wot, Wot, Wot, Wot, Wot, Wot, Wot, Wot, Wot, Wot, Wot, Wot, Wot, Wot, Wot, Wot, Wot, Wot, Wot, Wot, Wot, Wot, Wot, Wot, Wot, Wot, Wot, Wot, Wot, Wot, Wot, Wot, Wot, Wot, Wot, Wot, Wot, Wot, Wot
Wot, Wot, Wot, Wot, Wot, Wot, Wot, Wot, Wot, Wot, Wot, Wot, Wot, Wot, Wot, Wot, Wot, Wot, Wot, Wot, Wot, Wot, Wot, Wot, Wot, Wot, Wot, Wot, Wot, Wot, Wot, Wot, Wot, Wot, Wot, Wot, Wot, Wot, Wot, Wot, Wot, Wot, Wot, Wot, Wot, Wot, Wot
Wot, Wot, Wot, Wot, Wot, Wot, Wot, Wot, Wot, Wot, Wot, Wot, Wot, Wot, Wot, Wot, Wot, Wot, Wot, Wot, Wot, Wot, Wot, Wot, Wot, Wot, Wot, Wot, Wot, Wot, Wot, Wot, Wot, Wot, Wot, Wot, Wot, Wot, Wot, Wot, Wot, Wot, Wot, Wot, Wot, Wot, Wot
