Wot, Wot, Wot, Wot, Wot, Wot, Wot, Wot, Wot, Wot, Wot, Wot, Wot, Wot, Wot, Wot, Wwrt, Wwrt, Wwt, Wot, Wwt, Wot, Wwt, Wwt, Wwrt, Wot, Wot, Wot, Wot, Wot, Wot, Wot, Wwrt, Wot, Wot, Wot, Wot, Wot, Wot
Wot, Wot, Wot, Wot, Wot, Wot, Wot, Wot, Wot, Wot, Wot, Wot, Wot, Wot, Wwrt, Wwrt, Hh^Ft, Wwrt, Hh^Ft, Wwt, Wwt, Wwt, Gs^Ft, Wwt, Wwrt, Wot, Wot, Wot, Wwrt, Wwrt, Wwrt, Wwrt, Hd, Wot, Wwt, Wot, Wwrt, Wot, Wot
Wot, Wot, Wot, Wot, Wot, Wot, Wot, Wot, Wot, Wot, Wot, Wot, Wot, Wot, Gs^Ft, Gs^Ft, Hh, Hh, Hh^Ft, Hh^Ft, Gs^Vht, Gs^Ft, Gs^Ft, Wwt, Wwt, Wwrt, Wwrt, Wwrt, Wwt, Wwrt, Wwt, Hd, Wwt, Wwt, Wwrt, Wwrt, Wot, Wot, Wot
Wot, Wot, Wot, Wot, Wot, Wot, Wot, Wot, Wot, Wot, Wwrt, Wwrt, Wwrt, Gs^Ft, Gs^Ft, Hh^Ft, Gs^Ft, Hh^Ft, Gs^Ft, Gs^Ft, Gs^Ft, Gs^Ft, Gs^Ft, Gs^Ft, Gs^Ft, Wwt, Wwt, Wwt, Gs, Wwt, Dd, Wwt, Wwrt, Wwrt, Wot, Wot, Wot, Wot, Wot
Wot, Wot, Wot, Wot, Wot, Wot, Wot, Wot, Wot, Wot, Wwrt, Wwrt, Gs^Ft, Gs^Ft, Gs^Ft, Gs^Ft, Cme, Cme, Cme, Gs, Dd, Gs^Ft, Gs, Gs^Ft, Gs^Ft, Wwt, Gs^Ft, Gs^Ft, Gs, Dd, Wwt, Wwt, Wwrt, Wwrt, Wot, Wot, Wot, Wot, Wot
Wot, Wot, Wot, Wot, Wot, Wot, Wot, Wot, Wot, Wwrt, Wwt, Wwt, Gs^Ft, Gs^Vht, Wwrt, Wwrt, Cme, Kme, Cme, Wwrt, Wwrt, Dd, Dd, Dd, Dd, Gs^Ft, Dd, Gs, Dd, Dd, Wwt, Wwrt, Wwrt, Wot, Wwrt, Wwrt, Wot, Wot, Wot
Wot, Wot, Wot, Wot, Wot, Wot, Wot, Wot, Wwrt, Wwrt, Wwt, Wwt, Gs^Ft, Dd, Wwrt, Wwrt, Wwf, Cme, Wwrt, Wwrt, Dd, Dd, Wwt, Ww^Vm, Dd, Dd, Wwt, Dd, Wwt, Wwt, Wwt, Wwrt, Wwrt, Wwrt, Wwt, Wwrt, Wot, Wot, Wot
Wot, Wot, Wot, Wot, Wot, Wot, Wot, Wot, Wwrt, Wwt, Gs^Ft, Gs^Ft, Gs^Ft, Dd, Wwrt, Wwt, Ww^Vm, Wwf, Wwt, Wwrt, Wwf, Wwf, Wwt, Wwt, Wwt, Wwt, Wwt, Wwt, Wwt, Wwt, Cme, Cme, Cme, Wwt, Wwrt, Wwrt, Wot, Wot, Wot
Wot, Wot, Wot, Wot, Wot, Wot, Wot, Wwrt, Wwt, Wwt, Gs^Ft, Gs^Ft, Dd, Ww^Vm, Wwt, Wwt, Wwf, Wwt, Wwrt, Wwrt, Wwrt, Wwt, Wwt, Wwt, Wwt, Wwt, Ww^Vm, Hd, Hd, Wwt, Cme, Kme, Cme, Wwt, Wwt, Wot, Wot, Wot, Wot
Wot, Wot, Wot, Wot, Wwrt, Wot, Wwrt, Wwt, Wwt, Wwt, Gs^Ft, Gs, Dd, Dd, Wwf, Wwf, Hd, Hd, Wwf, Wwt, Wwt, Ww^Vm, Wwt, Wwt, Dd, Wwt, Hd, Hd, Wwt, Wwt, Wwt, Cme, Wwt, Wwt, Wwrt, Wot, Wot, Wot, Wot
Wot, Wot, Wot, Wot, Wwrt, Wwrt, Wwt, Wwt, Hd, Hd, Hd, Hd, Dd, Wwt, Wwt, Hd, Ww^Vm, Hd, Wwf, Wwt, Wwt, Wwt, Gs, Dd, Dd, Wwf, Wwrt, Wwrt, Wwrt, Wwrt, Wwrt, Wwt, Wot, Wwrt, Wot, Wot, Wot, Wot, Wot
Wot, Wot, Wwrt, Wwrt, Wwt, Wwt, Hd, Hd, Hd, Hd, Hd, Dd, Wwt, Wwt, Wwt, Wwt, Wwt, Wwf, Wwt, Wwt, Gs^Ft, Gs^Ft, Gs, Dd, Wwt, Wwf, Wwrt, Wwrt, Wot, Wot, Wot, Wot, Wot, Wot, Wot, Wot, Wot, Wot, Wot
Wot, Wot, Wot, Wwt, Wwt, Hd, Wwt, Hd, Ww^Vm, Hd, Dd, Dd, Wwt, Wwt, Wwt, Wot, Wwt, Wwt, Ww^Vm, Dd, Gs^Ft, Gs^Ft, Hd, Hd, Wwt, Wwt, Wwt, Wwrt, Wot, Wot, Wot, Wot, Wot, Wot, Wot, Wot, Wot, Wot, Wot
Wot, Wot, Wot, Wot, Wot, Wwt, Wot, Wwt, Wwt, Dd, Wwf, Wwt, Wwt, Wwt, Wot, Wot, Wwt, Wwt, Dd, Dd, Gs^Ft, Gs^Ft, Hd, Ww^Vm, Hd, Wwt, Wwt, Wwrt, Wwt, Wwt, Wot, Wot, Wot, Wot, Wot, Wot, Wot, Wot, Wot
Wot, Wot, Wot, Wot, Wot, Wot, Wwt, Wwt, Wwt, Wwf, Hd, Wwt, Wwrt, Wwrt, Wot, Wot, Wwt, Wwt, Cme, Gs^Ft, Gs^Ft, Gs^Ft, Hd, Hd, Wwt, Wwt, Wwrt, Wwrt, Hd, Wwt, Wot, Wot, Wwt, Wwt, Wwt, Wot, Wot, Wot, Wot
Wot, Wot, Wot, Wot, Wot, Wwt, Wwrt, Wwrt, Hd, Wwt, Wwt, Wwrt, Wwrt, Wot, Wwt, Wwt, Wwt, Cme, Kme, Cme, Hd, Hd, Ww^Vm, Wwt, Wwt, Wwrt, Wwt, Wwt, Wwf, Wwt, Wwt, Wwt, Wwt, Wwt, Wot, Wot, Wot, Wot, Wot
Wot, Wot, Wot, Wot, Wwrt, Wwrt, Wwrt, Hd, Wwrt, Wwf, Wwt, Wwt, Wwt, Wwt, Wwf, Wwt, Wwt, Cme, Cme, Cme, Hd, Hd, Wwt, Wwt, Wwt, Wwt, Hd, Hd, Wwf, Wwf, Wwf, Wwf, Ds, Wot, Wot, Wot, Wot, Wot, Wot
Wot, Wot, Wwrt, Wwrt, Wwrt, Wwrt, Wwrt, Wwrt, Wwf, Wwf, Hd, Hd, Hd, Hd, Ds, Wwf, Wwrt, Wwt, Wwt, Hd, Wwf, Wwt, Wwt, Wwt, Wwrt, Wwt, Wwt, Wwt, Wwt, Wwt, Ds, Ds, Ds, Wot, Wot, Wot, Wot, Wot, Wot
Wot, Wot, Wwrt, Wwrt, Wot, Wwrt, Wwrt, Wwrt, Wwt, Wwt, Hd, Hd, Ds, Ds, Wwt, Wwrt, Wot, Wwt, Wot, Wwf, Wwt, Wwt, Wwrt, Wwrt, Wot, Wwt, Wot, Wot, Wwt, Ww^Vm, Ds, Ds, Ww^Vm, Wot, Wot, Wot, Wot, Wot, Wot
Wot, Wot, Wot, Wot, Wot, Wot, Hd, Wwt, Wwt, Hd, Wwrt, Ww^Vm, Ds, Ww^Vm, Wwrt, Wwrt, Wot, Wot, Wot, Wwt, Wwrt, Wwt, Wwrt, Wot, Wot, Wot, Wot, Wwt, Wwt, Ds, Hd, Hd, Hd, Wot, Wot, Wot, Wot, Wot, Wot
Wot, Wot, Wot, Wot, Hd, Hd, Ww^Vm, Wwt, Wwrt, Wwrt, Wwt, Wwrt, Wwrt, Wwt, Wwrt, Wot, Wot, Wot, Wot, Wwrt, Wwrt, Wwrt, Wwrt, Wot, Wot, Wot, Wwt, Wwt, Hd, Hd, Hd, Hd, Wot, Wot, Wot, Wot, Wot, Wot, Wot
Wot, Wot, Wwt, Wwt, Ds, Hd, Hd, Wwf, Wwf, Wwt, Wwt, Wwrt, Wwrt, Wwrt, Wot, Wot, Wot, Wot, Wot, Wwrt, Wot, Wot, Wot, Wot, Wot, Wot, Wwt, Wwt, Wwt, Hd, Wot, Hd, Wot, Wot, Wot, Wot, Wot, Wot, Wot
Wwt, Wwt, Wwt, Ds, Ds, Ds, Ds, Ds, Wwt, Wwt, Wwrt, Wot, Wwt, Wot, Wot, Wot, Wot, Wot, Wot, Wot, Wot, Wot, Wot, Wot, Wot, Wwt, Wot, Wot, Wot, Wot, Wot, Wot, Wot, Wot, Wot, Wot, Wot, Wot, Wot
Wwt, Wwt, Wwt, Ds, Ds, Ds, Wwt, Ds, Wwt, Wwt, Wwrt, Wwrt, Wot, Wot, Wot, Wot, Wot, Wot, Wot, Wot, Wot, Wot, Wot, Wot, Wot, Wot, Wot, Wot, Wot, Wot, Wot, Wot, Wot, Wot, Wot, Wot, Wot, Wot, Wot
Wwt, Wwt, Wwt, Wwt, Wwt, Wwt, Wwt, Wwt, Wwt, Wwrt, Wwrt, Wwrt, Wwrt, Wot, Wot, Wot, Wot, Wot, Wot, Wot, Wot, Wot, Wot, Wot, Wot, Wot, Wot, Wot, Wot, Wot, Wot, Wot, Wot, Wot, Wot, Wot, Wot, Wot, Wot
